year,state,district,R_votes,D_votes,other_votes,total_votes,T_votes
1968,AL,1,11985,26206,84364,122555,84364
1968,AL,2,12198,22001,83064,117263,83064
1968,AL,3,8821,21267,84474,114562,84474
1968,AL,4,14174,21381,93179,128734,93179
1968,AL,5,13344,36229,80260,129833,80260
1968,AL,6,32467,39495,66373,138335,66373
1968,AL,7,29719,12910,104358,146987,104358
1968,AL,8,23576,16900,94659,135135,94659
1968,AK,AL,37600,35411,10024,83035,10024
1968,AZ,1,123796,61413,16592,201801,16592
1968,AZ,2,72539,61119,13666,147324,13666
1968,AZ,3,68471,47487,16094,132052,16094
1968,AR,1,30778,37835,52510,121123,52510
1968,AR,2,52012,51786,58345,162143,58345
1968,AR,3,76320,50450,59443,186213,59443
1968,AR,4,31649,48157,70684,150490,70684
1968,CA,1,86230,80311,14989,181530,14989
1968,CA,2,102158,91548,20860,214566,20860
1968,CA,3,80516,100361,12494,193371,12494
1968,CA,4,70176,75698,15841,161715,15841
1968,CA,5,36298,91233,8508,136039,8508
1968,CA,6,91258,108269,10673,210200,10673
1968,CA,7,54799,95700,6933,157432,6933
1968,CA,8,66032,85485,13954,165471,13954
1968,CA,9,68593,101698,13836,184127,13836
1968,CA,10,121967,109522,11639,243128,11639
1968,CA,11,97590,102699,14590,214879,14590
1968,CA,12,86251,73224,12321,171796,12321
1968,CA,13,123437,93614,14223,231274,14223
1968,CA,14,97486,101668,18330,217484,18330
1968,CA,15,78983,75579,13428,167990,13428
1968,CA,16,68544,76817,12830,158191,12830
1968,CA,17,63742,72905,14093,150740,14093
1968,CA,18,77615,66932,14959,159506,14959
1968,CA,19,75306,69873,10828,156007,10828
1968,CA,20,119172,63447,8570,191189,8570
1968,CA,21,6819,95865,1103,103787,1103
1968,CA,22,83993,84190,10214,178397,10214
1968,CA,23,70781,61086,15979,147846,15979
1968,CA,24,134207,64417,11812,210436,11812
1968,CA,25,118331,77335,15271,210937,15271
1968,CA,26,66470,132992,5040,204502,5040
1968,CA,27,123347,84116,15807,223270,15807
1968,CA,28,133767,91279,9581,234627,9581
1968,CA,29,59812,74517,7925,142254,7925
1968,CA,30,41396,68612,4292,114300,4292
1968,CA,31,60291,98940,8638,167869,8638
1968,CA,32,103848,71875,11634,187357,11634
1968,CA,33,97790,72897,18299,188986,18299
1968,CA,34,113470,76022,18076,207568,18076
1968,CA,35,198569,79687,17311,295567,17311
1968,CA,36,125185,70529,13837,209551,13837
1968,CA,37,70168,67401,12714,150283,12714
1968,CA,38,105379,87208,19940,212527,19940
1968,CO,1,92003,106081,11408,209492,11408
1968,CO,2,137972,93431,19201,250604,19201
1968,CO,3,81612,74305,15799,171716,15799
1968,CO,4,97788,61357,14405,173550,14405
1968,CT,1,79232,118164,9991,207387,9991
1968,CT,2,89943,102339,10883,203165,10883
1968,CT,3,88904,94258,15017,198179,15017
1968,CT,4,118374,100018,13607,231999,13607
1968,CT,5,89015,100841,16054,205910,16054
1968,CT,6,91253,105941,11098,208292,11098
1968,DE,AL,96714,89194,28459,214367,28459
1968,DC,AL,31012,139566,0,170578,0
1968,FL,1,31770,30241,97811,159822,97811
1968,FL,2,36203,42627,75520,154350,75520
1968,FL,3,39774,48866,52543,141183,52543
1968,FL,4,77766,54226,63866,195858,63866
1968,FL,5,94169,43972,52285,190426,52285
1968,FL,6,51933,46964,50928,149825,50928
1968,FL,7,94603,45749,57278,197630,57278
1968,FL,8,118978,74501,40780,234259,40780
1968,FL,9,114009,56279,44770,215058,44770
1968,FL,10,93160,74637,35299,203096,35299
1968,FL,11,42473,86918,19507,148898,19507
1968,FL,12,68567,59213,25428,153208,25428
1968,GA,1,34175,37733,58658,130566,58658
1968,GA,2,18413,21651,60162,100226,60162
1968,GA,3,23524,22248,45687,91459,45687
1968,GA,4,62507,44835,34825,142167,34825
1968,GA,5,54878,61820,28157,144855,28157
1968,GA,6,42407,34442,70857,147706,70857
1968,GA,7,49497,29053,76001,154551,76001
1968,GA,8,21232,20941,61168,103341,61168
1968,GA,9,35527,23078,55122,113727,55122
1968,GA,10,37503,38436,44731,120670,44731
1968,HI,1,46842,69715,1460,118017,1460
1968,HI,2,42770,70345,1648,114763,1648
1968,ID,1,87942,53664,19122,160728,19122
1968,ID,2,77427,35609,17419,130455,17419
1968,IL,1,10081,138835,1010,149926,1010
1968,IL,2,52311,103924,18896,175131,18896
1968,IL,3,69344,111357,16665,197366,16665
1968,IL,4,128964,73987,27581,230532,27581
1968,IL,5,70469,84599,28385,183453,28385
1968,IL,6,57423,92206,16549,166178,16549
1968,IL,7,18615,86195,6185,110995,6185
1968,IL,8,69019,90088,16484,175591,16484
1968,IL,9,69724,114570,8288,192582,8288
1968,IL,10,136834,79314,17615,233763,17615
1968,IL,11,113712,104352,1875,219939,1875
1968,IL,12,104153,57889,12470,174512,12470
1968,IL,13,156088,98305,9476,263869,9476
1968,IL,14,147354,71013,21316,239683,21316
1968,IL,15,108524,62158,12033,182715,12033
1968,IL,16,98077,61455,11041,170573,11041
1968,IL,17,112950,63879,19630,196459,19630
1968,IL,18,93503,71534,14044,179081,14044
1968,IL,19,94848,78285,13305,186438,13305
1968,IL,20,102316,74107,16208,192631,16208
1968,IL,21,105992,84105,21291,211388,21291
1968,IL,22,96274,72430,17446,186150,17446
1968,IL,23,99718,81947,19772,201437,19772
1968,IL,24,58551,83280,26512,168343,26512
1968,IN,1,57122,89136,25608,171866,25608
1968,IN,2,107535,64165,26833,198533,26833
1968,IN,3,93521,72363,18773,184657,18773
1968,IN,4,107471,72815,16276,196562,16276
1968,IN,5,104769,64062,19568,188399,19568
1968,IN,6,134885,66488,26499,227872,26499
1968,IN,7,100876,75121,24048,200045,24048
1968,IN,8,101042,84111,21191,206344,21191
1968,IN,9,95289,75907,25442,196638,25442
1968,IN,10,95630,71321,22321,189272,22321
1968,IN,11,69745,71170,16549,157464,16549
1968,IA,1,88955,76949,10476,176380,10476
1968,IA,2,96983,84210,9700,190893,9700
1968,IA,3,93640,63080,7648,164368,7648
1968,IA,4,82660,66913,9605,159178,9605
1968,IA,5,79750,75978,11884,167612,11884
1968,IA,6,96279,59311,6926,162516,6926
1968,IA,7,80839,50258,10283,141380,10283
1968,KS,1,102106,55355,14932,172393,14932
1968,KS,2,92559,54814,18004,165377,18004
1968,KS,3,96711,71328,21403,189442,21403
1968,KS,4,87658,60339,14278,162275,14278
1968,KS,5,96034,59057,19504,174595,19504
1968,KY,1,50419,61094,44779,156292,44779
1968,KY,2,61542,48772,28956,139270,28956
1968,KY,3,54960,64272,20488,139720,20488
1968,KY,4,82454,60317,33537,176308,33537
1968,KY,5,85254,36703,19485,141442,19485
1968,KY,6,66424,58723,30461,155608,30461
1968,KY,7,61358,67660,15392,144410,15392
1968,LA,1,32800,45114,57264,135178,57264
1968,LA,2,31152,46656,44479,122287,44479
1968,LA,3,50740,39857,69996,160593,69996
1968,LA,4,31525,32540,63402,127467,63402
1968,LA,5,25343,29968,71049,126360,71049
1968,LA,6,32642,36625,83087,152354,83087
1968,LA,7,24382,39378,68243,132003,68243
1968,LA,8,28693,41471,72780,142944,72780
1968,ME,1,88406,112843,3390,204639,3390
1968,ME,2,80848,104469,2980,188297,2980
1968,MD,1,64792,43139,30667,138598,30667
1968,MD,2,81707,52384,24248,158339,24248
1968,MD,3,31373,56078,21423,108874,21423
1968,MD,4,53272,59866,14517,127655,14517
1968,MD,5,77914,75771,36040,189725,36040
1968,MD,6,77686,52978,23667,154331,23667
1968,MD,7,35116,97023,10399,142538,10399
1968,MD,8,90507,96344,16989,203840,16989
1968,MA,1,71702,110313,8546,190561,8546
1968,MA,2,56157,114520,9000,179677,9000
1968,MA,3,67648,124927,5951,198526,5951
1968,MA,4,70871,127882,5725,204478,5725
1968,MA,5,70760,134795,6869,212424,6869
1968,MA,6,79134,128141,6734,214009,6734
1968,MA,7,60258,134490,6619,201367,6619
1968,MA,8,32246,119205,5547,156998,5547
1968,MA,9,18984,93954,7555,120493,7555
1968,MA,10,80088,122626,6863,209577,6863
1968,MA,11,63338,139835,10066,213239,10066
1968,MA,12,95259,118184,8504,221947,8504
1968,MI,1,16655,134437,5743,156835,5743
1968,MI,2,85262,74021,18158,177441,18158
1968,MI,3,95522,66035,18244,179801,18244
1968,MI,4,90599,55196,20442,166237,20442
1968,MI,5,94435,67946,12845,175226,12845
1968,MI,6,88645,66322,15113,170080,15113
1968,MI,7,72814,80373,26620,179807,26620
1968,MI,8,87375,60015,16719,164109,16719
1968,MI,9,100798,61539,14763,177100,14763
1968,MI,10,93778,63392,13043,170213,13043
1968,MI,11,78025,79327,9241,166593,9241
1968,MI,12,63837,115903,29634,209374,29634
1968,MI,13,11302,88625,5313,105240,5313
1968,MI,14,59930,96737,20717,177384,20717
1968,MI,15,47202,93045,27022,167269,27022
1968,MI,16,43432,95603,20268,159303,20268
1968,MI,17,55093,106860,17695,179648,17695
1968,MI,18,100114,102817,17150,220081,17150
1968,MI,19,85847,84889,23238,193974,23238
1968,MN,1,98996,102299,8056,209351,8056
1968,MN,2,88725,74900,7416,171041,7416
1968,MN,3,116344,136013,10277,262634,10277
1968,MN,4,74989,139017,10070,224076,10070
1968,MN,5,70016,114721,8455,193192,8455
1968,MN,6,82894,95102,9398,187394,9398
1968,MN,7,76302,77796,8190,162288,8190
1968,MN,8,50377,117890,7069,175336,7069
1968,MS,1,15273,29392,68020,112685,68020
1968,MS,2,17832,29660,82062,129554,82062
1968,MS,3,22236,41696,77047,140979,77047
1968,MS,4,11377,28724,87546,127647,87546
1968,MS,5,21798,21172,100674,143644,100674
1968,MO,1,24389,92774,18640,135803,18640
1968,MO,2,102107,95631,21057,218795,21057
1968,MO,3,51497,74642,6504,132643,6504
1968,MO,4,91360,77044,25985,194389,25985
1968,MO,5,47300,72425,12997,132722,12997
1968,MO,6,96584,82725,20158,199467,20158
1968,MO,7,115434,64721,20346,200501,20346
1968,MO,8,101211,76909,23612,201732,23612
1968,MO,9,100784,87016,26194,213994,26194
1968,MO,10,70098,59797,29122,159017,29122
1968,MT,1,67386,60338,11406,139130,11406
1968,MT,2,71449,53779,8609,133837,8609
1968,NE,1,110909,61274,11633,183816,11633
1968,NE,2,84690,59078,19044,162812,19044
1968,NE,3,125564,50432,14227,190223,14227
1968,NV,AL,73188,60598,20432,154218,20432
1968,NH,1,77568,63097,6197,146862,6197
1968,NH,2,77335,67492,4976,149803,4976
1968,NJ,1,75496,88661,28110,192267,28110
1968,NJ,2,77572,78078,20029,175679,20029
1968,NJ,3,101891,83308,16248,201447,16248
1968,NJ,4,93198,93120,23887,210205,23887
1968,NJ,5,127971,79978,16990,224939,16990
1968,NJ,6,113906,87786,24283,225975,24283
1968,NJ,7,118424,79234,11634,209292,11634
1968,NJ,8,79862,74442,16617,170921,16617
1968,NJ,9,106487,82948,12029,201464,12029
1968,NJ,10,59822,78790,13527,152139,13527
1968,NJ,11,51420,86733,10989,149142,10989
1968,NJ,12,114175,90462,14040,218677,14040
1968,NJ,13,53426,89058,16243,158727,16243
1968,NJ,14,62537,74700,15103,152340,15103
1968,NJ,15,88943,96598,22436,207977,22436
1968,NM,1,91729,75328,7850,174907,7850
1968,NM,2,77963,54753,17887,150603,17887
1968,NY,1,141652,80628,21863,244143,21863
1968,NY,2,112403,74103,13606,200112,13606
1968,NY,3,96635,93216,7655,197506,7655
1968,NY,4,101605,80664,9553,191822,9553
1968,NY,5,106987,90806,10713,208506,10713
1968,NY,6,76226,81892,9043,167161,9043
1968,NY,7,54289,97611,9148,161048,9148
1968,NY,8,77066,103494,10468,191028,10468
1968,NY,9,73002,66308,12029,151339,12029
1968,NY,10,41616,97474,4530,143620,4530
1968,NY,11,39466,75409,5784,120659,5784
1968,NY,12,10165,46151,1742,58058,1742
1968,NY,13,46662,121925,5662,174249,5662
1968,NY,14,26664,47221,5067,78952,5067
1968,NY,15,57712,69634,10061,137407,10061
1968,NY,16,83380,52197,10130,145707,10130
1968,NY,17,69454,107385,4356,181195,4356
1968,NY,18,7967,75508,528,84003,528
1968,NY,19,27118,70664,3996,101778,3996
1968,NY,20,29008,86030,3560,118598,3560
1968,NY,21,20008,54578,3406,77992,3406
1968,NY,22,32133,67815,5351,105299,5351
1968,NY,23,36457,94075,5486,136018,5486
1968,NY,24,82478,80277,13090,175845,13090
1968,NY,25,114492,91951,13616,220059,13616
1968,NY,26,97911,86007,8516,192434,8516
1968,NY,27,107579,86238,15327,209144,15327
1968,NY,28,117884,71939,12812,202635,12812
1968,NY,29,91496,116334,8545,216375,8545
1968,NY,30,96437,87780,8448,192665,8448
1968,NY,31,75664,58115,6365,140144,6365
1968,NY,32,87607,73627,8703,169937,8703
1968,NY,33,89846,72412,9609,171867,9609
1968,NY,34,93909,79391,9006,182306,9006
1968,NY,35,100726,76105,8661,185492,8661
1968,NY,36,102524,98196,7184,207904,7184
1968,NY,37,97269,93270,9272,199811,9272
1968,NY,38,89140,68496,9470,167106,9470
1968,NY,39,89293,110304,15298,214895,15298
1968,NY,40,72072,84876,11480,168428,11480
1968,NY,41,27836,101021,10223,139080,10223
1968,NC,1,25900,42458,56357,124715,56357
1968,NC,2,24909,39540,57201,121650,57201
1968,NC,3,35991,31070,46384,113445,46384
1968,NC,4,65025,54791,44768,164584,44768
1968,NC,5,79060,42810,41442,163312,41442
1968,NC,6,60437,42756,45065,148258,45065
1968,NC,7,32532,38090,40764,111386,40764
1968,NC,8,60185,39399,45502,145086,45502
1968,NC,9,84265,44521,35128,163914,35128
1968,NC,10,78590,38602,45847,163039,45847
1968,NC,11,80298,50076,37730,168104,37730
1968,ND,1,70953,54063,7223,132239,7223
1968,ND,2,67716,40706,7021,115443,7021
1968,OH,1,81727,66863,18825,167415,18825
1968,OH,2,88208,61387,23052,172647,23052
1968,OH,3,62206,74485,17288,153979,17288
1968,OH,4,90751,60681,18766,170198,18766
1968,OH,5,89569,62510,15876,167955,15876
1968,OH,6,77496,55649,26975,160120,26975
1968,OH,7,78637,63362,21868,163867,21868
1968,OH,8,87364,57022,16657,161043,16657
1968,OH,9,64081,81932,15082,161095,15082
1968,OH,10,81045,60911,16375,158331,16375
1968,OH,11,76457,71669,21474,169600,21474
1968,OH,12,91586,64102,26102,181790,26102
1968,OH,13,74482,75812,20348,170642,20348
1968,OH,14,61217,78074,18759,158050,18759
1968,OH,15,83846,49915,19320,153081,19320
1968,OH,16,87148,69459,19460,176067,19460
1968,OH,17,86023,57690,18672,162385,18672
1968,OH,18,65713,84870,14204,164787,14204
1968,OH,19,50928,92517,16648,160093,16648
1968,OH,20,31726,66428,18122,116276,18122
1968,OH,21,15112,103450,11217,129779,11217
1968,OH,22,79014,98780,16817,194611,16817
1968,OH,23,103569,88303,22674,214546,22674
1968,OH,24,78563,52006,32059,162628,32059
1968,OK,1,88410,37899,32356,158665,32356
1968,OK,2,72075,53690,34037,159802,34037
1968,OK,3,50520,58656,40142,149318,40142
1968,OK,4,58862,53790,32067,144719,32067
1968,OK,5,81130,50981,26996,159107,26996
1968,OK,6,95034,45157,25067,165258,25067
1968,OR,1,132575,105214,12053,249842,12053
1968,OR,2,98678,71832,12111,182621,12111
1968,OR,3,85621,108230,9807,203658,9807
1968,OR,4,91559,73590,15712,180861,15712
1968,PA,1,38520,109562,11255,159337,11255
1968,PA,2,36759,111175,5523,153457,5523
1968,PA,3,42283,78505,9682,130470,9682
1968,PA,4,88325,123040,22112,233477,22112
1968,PA,5,48266,103496,14934,166696,14934
1968,PA,6,87817,84859,12474,185150,12474
1968,PA,7,99140,79916,17276,196332,17276
1968,PA,8,84963,66257,16890,168110,16890
1968,PA,9,90487,52218,16902,159607,16902
1968,PA,10,94081,88716,8813,191610,8813
1968,PA,11,79200,97861,9606,186667,9606
1968,PA,12,105222,59742,15489,180453,15489
1968,PA,13,128536,95947,14183,238666,14183
1968,PA,14,35277,91248,13083,139608,13083
1968,PA,15,85260,90996,8145,184401,8145
1968,PA,16,95239,40999,11472,147710,11472
1968,PA,17,107510,64123,13945,185578,13945
1968,PA,18,91938,82308,21344,195590,21344
1968,PA,19,95842,54788,14526,165156,14526
1968,PA,20,40745,96127,22475,159347,22475
1968,PA,21,53200,82842,14722,150764,14722
1968,PA,22,80602,79501,11078,171181,11078
1968,PA,23,81823,61365,8633,151821,8633
1968,PA,24,81256,85763,9733,176752,9733
1968,PA,25,68242,85838,15748,169828,15748
1968,PA,26,51049,89334,15808,156191,15808
1968,PA,27,85344,87266,21054,193664,21054
1968,RI,1,51891,112101,5833,169825,5833
1968,RI,2,70468,134417,9845,214730,9845
1968,SC,1,42966,42331,31220,116517,31220
1968,SC,2,47624,36004,28028,111656,28028
1968,SC,3,41678,26585,47223,115486,47223
1968,SC,4,54648,27411,36866,118925,36866
1968,SC,5,34909,30689,39356,104954,39356
1968,SC,6,32237,34466,32737,99440,32737
1968,SD,1,79757,65655,5876,151288,5876
1968,SD,2,70084,52368,7524,129976,7524
1968,TN,1,83465,27267,27764,138496,27764
1968,TN,2,78481,36277,28759,143517,28759
1968,TN,3,56137,38433,47956,142526,47956
1968,TN,4,50662,38383,42400,131445,42400
1968,TN,5,44175,44543,47889,136607,47889
1968,TN,6,30987,36667,65166,132820,65166
1968,TN,7,45001,46218,57647,148866,57647
1968,TN,8,30505,36667,62172,129344,62172
1968,TN,9,53179,46778,45039,144996,45039
1968,TX,1,35395,48345,47344,131084,47344
1968,TX,2,37836,48466,50961,137263,50961
1968,TX,3,79617,51767,24068,155452,24068
1968,TX,4,49925,48779,38472,137176,38472
1968,TX,5,64402,54664,21050,140116,21050
1968,TX,6,60284,60560,35115,155959,35115
1968,TX,7,85546,48329,28308,162183,28308
1968,TX,8,22831,57868,26061,106760,26061
1968,TX,9,43297,57290,33475,134062,33475
1968,TX,10,54549,67709,19848,142106,19848
1968,TX,11,34121,56813,21498,112432,21498
1968,TX,12,53349,61672,16950,131971,16950
1968,TX,13,70847,57924,24255,153026,24255
1968,TX,14,48963,72452,23142,144557,23142
1968,TX,15,32628,50487,6095,89210,6095
1968,TX,16,38442,40979,10391,89812,10391
1968,TX,17,49137,56547,23633,129317,23633
1968,TX,18,66410,38032,27689,132131,27689
1968,TX,19,55781,36848,25690,118319,25690
1968,TX,20,18062,54810,4676,77548,4676
1968,TX,21,80168,51053,25356,156577,25356
1968,TX,22,73607,68164,26843,168614,26843
1968,TX,23,37197,61524,14295,113016,14295
1968,UT,1,122293,70363,15185,207841,15185
1968,UT,2,116435,86302,11721,214458,11721
1968,VT,AL,85142,70255,6007,161404,6007
1968,VA,1,53955,46022,44618,144595,44618
1968,VA,2,31704,44211,26627,102542,26627
1968,VA,3,82607,47172,30697,160476,30697
1968,VA,4,38455,40712,44678,123845,44678
1968,VA,5,47702,34838,48491,131031,48491
1968,VA,6,68099,32892,29471,130462,29471
1968,VA,7,67004,30026,24250,121280,24250
1968,VA,8,63769,50200,33683,147652,33683
1968,VA,9,56296,44664,19516,120476,19516
1968,VA,10,80728,71600,19802,172130,19802
1968,WA,1,102918,92510,10579,206007,10579
1968,WA,2,87466,93506,15728,196700,15728
1968,WA,3,69025,84962,10985,164972,10985
1968,WA,4,83420,61301,13575,158296,13575
1968,WA,5,77621,69968,13192,160781,13192
1968,WA,6,66930,96553,14759,178242,14759
1968,WA,7,79649,101883,15588,197120,15588
1968,WV,1,66470,86743,13315,166528,13315
1968,WV,2,72571,68663,15124,156358,15124
1968,WV,3,61378,70731,15745,147854,15745
1968,WV,4,68870,71244,15031,155145,15031
1968,WV,5,38266,76710,13345,128321,13345
1968,WI,1,85386,76544,16415,178345,16415
1968,WI,2,82439,87814,8824,179077,8824
1968,WI,3,86474,58514,11373,156361,11373
1968,WI,4,55976,91625,17389,164990,17389
1968,WI,5,40750,67361,9151,117262,9151
1968,WI,6,96588,72596,11421,180605,11421
1968,WI,7,82321,68224,13683,164228,13683
1968,WI,8,91703,66639,12689,171031,12689
1968,WI,9,110853,78988,15437,205278,15437
1968,WI,10,77507,80499,11453,169459,11453
1968,WY,AL,70927,45173,11105,127205,11105
1972,AL,1,103842,33276,0,137118,0
1972,AL,2,107702,31190,0,138892,0
1972,AL,3,98640,33480,0,132120,0
1972,AL,4,117823,34059,0,151882,0
1972,AL,5,98504,33603,0,132107,0
1972,AL,6,108102,41625,0,149727,0
1972,AL,7,92421,47536,0,139957,0
1972,AK,AL,55349,32967,6903,95219,6903
1972,AZ,1,98436,46573,0,145009,0
1972,AZ,2,89052,65926,0,154978,0
1972,AZ,3,104197,41012,0,145209,0
1972,AZ,4,111127,45029,0,156156,0
1972,AR,1,98979,45355,0,144334,0
1972,AR,2,100761,56514,0,157275,0
1972,AR,3,138541,47922,0,186463,0
1972,AR,4,107470,49108,0,156578,0
1972,CA,1,123735,95522,0,219257,0
1972,CA,2,115742,94060,0,209802,0
1972,CA,3,104534,107849,0,212383,0
1972,CA,4,91739,77896,0,169635,0
1972,CA,5,60503,107755,0,168258,0
1972,CA,6,121081,110541,0,231622,0
1972,CA,7,75856,139721,0,215577,0
1972,CA,8,97446,89062,0,186508,0
1972,CA,9,80269,88293,0,168562,0
1972,CA,10,129770,84716,0,214486,0
1972,CA,11,103931,90388,0,194319,0
1972,CA,12,106577,83510,0,190087,0
1972,CA,13,130134,72367,0,202501,0
1972,CA,14,110079,90872,0,200951,0
1972,CA,15,93600,75020,0,168620,0
1972,CA,16,87864,79980,0,167844,0
1972,CA,17,106566,97748,0,204314,0
1972,CA,18,100122,65449,0,165571,0
1972,CA,19,91302,63474,0,154776,0
1972,CA,20,144889,68650,0,213539,0
1972,CA,21,31413,91077,0,122490,0
1972,CA,22,101594,79296,0,180890,0
1972,CA,23,135119,57301,0,192420,0
1972,CA,24,148177,55323,0,203500,0
1972,CA,25,126156,53059,0,179215,0
1972,CA,26,111555,135535,0,247090,0
1972,CA,27,129909,74361,0,204270,0
1972,CA,28,133911,104629,0,238540,0
1972,CA,29,80484,67490,0,147974,0
1972,CA,30,55563,60305,0,115868,0
1972,CA,31,96740,72054,0,168794,0
1972,CA,32,149953,73970,0,223923,0
1972,CA,33,123412,59603,0,183015,0
1972,CA,34,110310,56370,0,166680,0
1972,CA,35,76784,65870,0,142654,0
1972,CA,36,95059,64929,0,159988,0
1972,CA,37,62666,109673,0,172339,0
1972,CA,38,71319,64824,0,136143,0
1972,CA,39,164958,56293,0,221251,0
1972,CA,40,144144,80734,0,224878,0
1972,CA,41,86387,66009,0,152396,0
1972,CA,42,160940,68162,0,229102,0
1972,CA,43,117994,66770,0,184764,0
1972,CO,1,101950,82403,0,184353,0
1972,CO,2,142326,76789,0,219115,0
1972,CO,3,102569,57152,0,159721,0
1972,CO,4,129253,63181,0,192434,0
1972,CO,5,121492,50546,0,172038,0
1972,CT,1,121196,114473,2453,238122,2453
1972,CT,2,127923,85382,2293,215598,2293
1972,CT,3,142569,87766,3384,233719,3384
1972,CT,4,138496,81802,3599,223897,3599
1972,CT,5,144149,87747,3664,235560,3664
1972,CT,6,136430,98328,2623,237381,2623
1972,DE,AL,140357,92283,2876,235516,2876
1972,DC,AL,35226,127627,568,163421,568
1972,FL,1,127607,24860,0,152467,0
1972,FL,2,111042,50861,0,161903,0
1972,FL,3,96783,41880,0,138663,0
1972,FL,4,135945,41660,0,177605,0
1972,FL,5,143766,44600,0,188366,0
1972,FL,6,154765,68214,0,222979,0
1972,FL,7,99739,43347,0,143086,0
1972,FL,8,134071,34768,0,168839,0
1972,FL,9,132323,32041,0,164364,0
1972,FL,10,157854,41504,0,199358,0
1972,FL,11,146024,50733,0,196757,0
1972,FL,12,140157,54394,0,194551,0
1972,FL,13,90997,72957,0,163954,0
1972,FL,14,70005,50458,0,120463,0
1972,FL,15,104864,60483,0,165347,0
1972,GA,1,90218,29768,0,119986,0
1972,GA,2,80769,20745,0,101514,0
1972,GA,3,81300,23534,0,104834,0
1972,GA,4,110574,33043,0,143617,0
1972,GA,5,69088,63405,0,132493,0
1972,GA,6,96213,24717,0,120930,0
1972,GA,7,91477,18726,0,110203,0
1972,GA,8,91338,26033,0,117371,0
1972,GA,9,89299,19544,0,108843,0
1972,GA,10,81220,30014,0,111234,0
1972,HI,1,82729,49994,0,132723,0
1972,HI,2,86136,51415,0,137551,0
1972,ID,1,99087,45309,0,144396,0
1972,ID,2,100297,35517,0,135814,0
1972,IL,1,16998,145003,0,162001,0
1972,IL,2,60220,116534,0,176754,0
1972,IL,3,155092,65226,0,220318,0
1972,IL,4,142635,57082,0,199717,0
1972,IL,5,86644,96012,0,182656,0
1972,IL,6,147633,66815,0,214448,0
1972,IL,7,33266,93318,0,126584,0
1972,IL,8,71343,90093,0,161436,0
1972,IL,9,79997,111512,0,191509,0
1972,IL,10,147305,89630,0,236935,0
1972,IL,11,144169,85928,0,230097,0
1972,IL,12,136343,56896,0,193239,0
1972,IL,13,112900,49217,0,162117,0
1972,IL,14,163652,53631,0,217283,0
1972,IL,15,133061,68288,0,201349,0
1972,IL,16,120432,62339,0,182771,0
1972,IL,17,122873,62394,0,185267,0
1972,IL,18,128747,67503,0,196250,0
1972,IL,19,124549,77194,0,201743,0
1972,IL,20,137414,78281,0,215695,0
1972,IL,21,117230,70380,0,187610,0
1972,IL,22,141820,80804,0,222624,0
1972,IL,23,87654,76971,0,164625,0
1972,IL,24,138435,92910,0,231345,0
1972,IN,1,91218,82173,0,173391,0
1972,IN,2,149099,53463,0,202562,0
1972,IN,3,120430,66985,0,187415,0
1972,IN,4,130321,63938,0,194259,0
1972,IN,5,135915,58893,0,194808,0
1972,IN,6,127566,45691,0,173257,0
1972,IN,7,135270,72718,0,207988,0
1972,IN,8,138545,73835,0,212380,0
1972,IN,9,123569,70613,0,194182,0
1972,IN,10,129455,57073,0,186528,0
1972,IN,11,125009,63456,0,188465,0
1972,IA,1,111577,87448,0,199025,0
1972,IA,2,108517,86714,0,195231,0
1972,IA,3,119372,78687,0,198059,0
1972,IA,4,117283,92752,0,210035,0
1972,IA,5,125720,74495,0,200215,0
1972,IA,6,123738,76110,0,199848,0
1972,KS,1,135605,52842,0,188447,0
1972,KS,2,119234,51093,0,170327,0
1972,KS,3,122474,61367,0,183841,0
1972,KS,4,110805,52191,0,162996,0
1972,KS,5,124835,50528,0,175363,0
1972,KY,1,87072,51802,0,138874,0
1972,KY,2,88384,46922,0,135306,0
1972,KY,3,78143,63796,0,141939,0
1972,KY,4,112607,47238,0,159845,0
1972,KY,5,117821,44287,0,162108,0
1972,KY,6,101147,50777,0,151924,0
1972,KY,7,93088,67062,0,160150,0
1972,LA,1,91347,37676,0,129023,0
1972,LA,2,65036,43702,0,108738,0
1972,LA,3,102047,31647,0,133694,0
1972,LA,4,89754,29203,0,118957,0
1972,LA,5,97039,35213,0,132252,0
1972,LA,6,83246,36240,0,119486,0
1972,LA,7,85502,41032,0,126534,0
1972,LA,8,73297,43429,0,116726,0
1972,ME,1,135388,85028,100,220516,100
1972,ME,2,121120,75556,129,196805,129
1972,MD,1,106539,42257,0,148796,0
1972,MD,2,135329,62755,0,198084,0
1972,MD,3,111007,53981,0,164988,0
1972,MD,4,107379,44937,0,152316,0
1972,MD,5,83579,63821,0,147400,0
1972,MD,6,125878,52346,0,178224,0
1972,MD,7,32369,89041,0,121410,0
1972,MD,8,127225,96643,0,223868,0
1972,MA,1,102513,107528,0,210041,0
1972,MA,2,88652,95348,0,184000,0
1972,MA,3,83423,98449,0,181872,0
1972,MA,4,92341,116100,0,208441,0
1972,MA,5,106658,120470,0,227128,0
1972,MA,6,104027,116157,0,220184,0
1972,MA,7,91607,122026,0,213633,0
1972,MA,8,65660,127868,0,193528,0
1972,MA,9,68748,100720,0,169468,0
1972,MA,10,100844,102368,0,203212,0
1972,MA,11,86139,112397,0,198536,0
1972,MA,12,121406,113109,0,234515,0
1972,MI,1,22815,137732,0,160547,0
1972,MI,2,106155,85093,0,191248,0
1972,MI,3,118023,71608,0,189631,0
1972,MI,4,116712,55846,0,172558,0
1972,MI,5,117832,75224,0,193056,0
1972,MI,6,115810,80875,0,196685,0
1972,MI,7,90776,76745,0,167521,0
1972,MI,8,106524,65422,0,171946,0
1972,MI,9,130463,64561,0,195024,0
1972,MI,10,119706,66980,0,186686,0
1972,MI,11,117006,86548,0,203554,0
1972,MI,12,112291,61288,0,173579,0
1972,MI,13,20561,104556,0,125117,0
1972,MI,14,85618,57045,0,142663,0
1972,MI,15,94812,61803,0,156615,0
1972,MI,16,95564,82219,0,177783,0
1972,MI,17,118347,77659,0,196006,0
1972,MI,18,115552,68193,0,183745,0
1972,MI,19,122205,57144,0,179349,0
1972,MN,1,122634,82155,0,204789,0
1972,MN,2,129432,88633,0,218065,0
1972,MN,3,129587,89281,0,218868,0
1972,MN,4,95201,107924,0,203125,0
1972,MN,5,92951,116090,0,209041,0
1972,MN,6,114196,102231,0,216427,0
1972,MN,7,118727,100410,0,219137,0
1972,MN,8,95539,115622,0,211161,0
1972,MS,1,92680,23058,0,115738,0
1972,MS,2,84346,24633,0,108979,0
1972,MS,3,110710,28941,0,139651,0
1972,MS,4,101007,32496,0,133503,0
1972,MS,5,116382,17654,0,134036,0
1972,MO,1,45765,101307,0,147072,0
1972,MO,2,127123,75564,0,202687,0
1972,MO,3,102959,73362,0,176321,0
1972,MO,4,131874,60472,0,192346,0
1972,MO,5,80553,71527,0,152080,0
1972,MO,6,134977,65754,0,200731,0
1972,MO,7,153239,57616,0,210855,0
1972,MO,8,124585,58036,0,182621,0
1972,MO,9,129159,69218,0,198377,0
1972,MO,10,111777,57754,0,169531,0
1972,MT,1,92166,65384,0,157550,0
1972,MT,2,91810,54813,0,146623,0
1972,NE,1,133300,66018,0,199318,0
1972,NE,2,124823,56211,0,181034,0
1972,NE,3,148175,47762,0,195937,0
1972,NV,AL,115750,66016,0,181766,0
1972,NH,1,111167,54375,2003,167545,2003
1972,NH,2,102557,62060,1897,166514,1897
1972,NJ,1,112632,74821,0,187453,0
1972,NJ,2,138957,73018,0,211975,0
1972,NJ,3,133272,65028,0,198300,0
1972,NJ,4,102645,74902,0,177547,0
1972,NJ,5,139407,73268,0,212675,0
1972,NJ,6,130276,67191,0,197467,0
1972,NJ,7,150619,76583,0,227202,0
1972,NJ,8,111671,65125,0,176796,0
1972,NJ,9,146286,74851,0,221137,0
1972,NJ,10,46034,78416,0,124450,0
1972,NJ,11,128378,84859,0,213237,0
1972,NJ,12,130187,77367,0,207554,0
1972,NJ,13,141609,61509,0,203118,0
1972,NJ,14,104907,71098,0,176005,0
1972,NJ,15,118439,74752,0,193191,0
1972,NM,1,125326,85996,0,211322,0
1972,NM,2,110280,55088,0,165368,0
1972,NY,1,141383,59420,0,200803,0
1972,NY,2,123030,46695,0,169725,0
1972,NY,3,137271,68617,0,205888,0
1972,NY,4,138983,78124,0,217107,0
1972,NY,5,145996,87445,0,233441,0
1972,NY,6,140072,84880,0,224952,0
1972,NY,7,66305,93806,0,160111,0
1972,NY,8,94222,95212,0,189434,0
1972,NY,9,128699,46700,0,175399,0
1972,NY,10,103372,60343,0,163715,0
1972,NY,11,80662,75129,0,155791,0
1972,NY,12,11937,64673,0,76610,0
1972,NY,13,91690,97155,0,188845,0
1972,NY,14,45586,49825,0,95411,0
1972,NY,15,107188,51109,0,158297,0
1972,NY,16,74403,86597,0,161000,0
1972,NY,17,105543,64601,0,170144,0
1972,NY,18,82516,114237,0,196753,0
1972,NY,19,24302,106164,0,130466,0
1972,NY,20,57319,109341,0,166660,0
1972,NY,21,15293,59375,0,74668,0
1972,NY,22,67371,101683,0,169054,0
1972,NY,23,120690,79152,0,199842,0
1972,NY,24,135553,87068,0,222621,0
1972,NY,25,148003,63536,0,211539,0
1972,NY,26,133873,63450,0,197323,0
1972,NY,27,141972,81179,0,223151,0
1972,NY,28,134123,101128,0,235251,0
1972,NY,29,156842,67570,0,224412,0
1972,NY,30,122127,60180,0,182307,0
1972,NY,31,140433,61141,0,201574,0
1972,NY,32,138607,60343,0,198950,0
1972,NY,33,135504,59196,0,194700,0
1972,NY,34,130757,77699,0,208456,0
1972,NY,35,134216,70126,0,204342,0
1972,NY,36,119213,78931,0,198144,0
1972,NY,37,74998,99509,0,174507,0
1972,NY,38,132331,85221,0,217552,0
1972,NY,39,101792,51963,0,153755,0
1972,NC,1,83557,35333,0,118890,0
1972,NC,2,86006,47674,0,133680,0
1972,NC,3,79431,27878,0,107309,0
1972,NC,4,107283,47343,0,154626,0
1972,NC,5,109952,45830,0,155782,0
1972,NC,6,97946,38163,0,136109,0
1972,NC,7,71346,30409,0,101755,0
1972,NC,8,100830,37880,0,138710,0
1972,NC,9,102879,23918,0,126797,0
1972,NC,10,105093,38202,0,143295,0
1972,NC,11,110566,46095,0,156661,0
1972,ND,AL,174109,100384,6021,280514,6021
1972,OH,1,111925,57516,0,169441,0
1972,OH,2,127655,61676,0,189331,0
1972,OH,3,88701,63890,0,152591,0
1972,OH,4,120089,49780,0,169869,0
1972,OH,5,118678,62332,0,181010,0
1972,OH,6,118484,49892,0,168376,0
1972,OH,7,106807,52240,0,159047,0
1972,OH,8,104889,47638,0,152527,0
1972,OH,9,83768,87151,0,170919,0
1972,OH,10,119083,58831,0,177914,0
1972,OH,11,104236,63864,0,168100,0
1972,OH,12,128129,61644,0,189773,0
1972,OH,13,98505,68481,0,166986,0
1972,OH,14,88384,94320,0,182704,0
1972,OH,15,119846,65381,0,185227,0
1972,OH,16,113402,61173,0,174575,0
1972,OH,17,111545,50374,0,161919,0
1972,OH,18,111800,72581,0,184381,0
1972,OH,19,96607,88500,0,185107,0
1972,OH,20,79056,74041,0,153097,0
1972,OH,21,27661,101276,0,128937,0
1972,OH,22,119412,90689,0,210101,0
1972,OH,23,131709,71361,0,203070,0
1972,OK,1,133381,35199,0,168580,0
1972,OK,2,126446,46648,0,173094,0
1972,OK,3,113281,47962,0,161243,0
1972,OK,4,107548,37542,0,145090,0
1972,OK,5,126859,39955,0,166814,0
1972,OK,6,150998,39712,0,190710,0
1972,OR,1,137345,101616,0,238961,0
1972,OR,2,123857,81195,0,205052,0
1972,OR,3,106955,115283,0,222238,0
1972,OR,4,117977,94456,0,212433,0
1972,PA,1,77078,107549,0,184627,0
1972,PA,2,39889,121786,0,161675,0
1972,PA,3,74829,86379,0,161208,0
1972,PA,4,131066,100940,0,232006,0
1972,PA,5,131393,58454,0,189847,0
1972,PA,6,114537,66807,0,181344,0
1972,PA,7,133151,73432,0,206583,0
1972,PA,8,118601,64330,0,182931,0
1972,PA,9,114144,40131,0,154275,0
1972,PA,10,125686,71105,0,196791,0
1972,PA,11,113556,68764,0,182320,0
1972,PA,12,112694,64049,0,176743,0
1972,PA,13,135464,77715,0,213179,0
1972,PA,14,86912,95687,0,182599,0
1972,PA,15,99664,65557,0,165221,0
1972,PA,16,115651,37223,0,152874,0
1972,PA,17,119178,48205,0,167383,0
1972,PA,18,125938,74949,0,200887,0
1972,PA,19,115528,45769,0,161297,0
1972,PA,20,108506,83576,0,192082,0
1972,PA,21,99366,73049,0,172415,0
1972,PA,22,95927,72151,0,168078,0
1972,PA,23,105463,54138,0,159601,0
1972,PA,24,107785,69394,0,177179,0
1972,PA,25,103715,67926,0,171641,0
1972,RI,1,107156,98881,0,206037,0
1972,RI,2,113072,94935,0,208007,0
1972,SC,1,73480,33488,0,106968,0
1972,SC,2,85637,37756,0,123393,0
1972,SC,3,84401,24723,0,109124,0
1972,SC,4,77547,19702,0,97249,0
1972,SC,5,78994,32044,0,111038,0
1972,SC,6,76985,36846,0,113831,0
1972,SD,1,80576,76932,497,158005,497
1972,SD,2,85900,62013,497,148410,497
1972,TN,1,113840,31200,0,145040,0
1972,TN,2,112505,40799,0,153304,0
1972,TN,3,108187,41430,0,149617,0
1972,TN,4,82879,44719,0,127598,0
1972,TN,5,89046,53175,0,142221,0
1972,TN,6,104742,39799,0,144541,0
1972,TN,7,105072,34241,0,139313,0
1972,TN,8,96876,71930,0,168806,0
1972,TX,1,99658,41763,0,141421,0
1972,TX,2,98598,47499,0,146097,0
1972,TX,3,136195,39892,0,176087,0
1972,TX,4,107025,36736,0,143761,0
1972,TX,5,98434,43360,0,141794,0
1972,TX,6,107759,43773,0,151532,0
1972,TX,7,107655,24069,0,131724,0
1972,TX,8,63861,53672,0,117533,0
1972,TX,9,84903,57669,0,142572,0
1972,TX,10,103675,71652,0,175327,0
1972,TX,11,90802,40234,0,131036,0
1972,TX,12,73669,45183,0,118852,0
1972,TX,13,118004,37575,0,155579,0
1972,TX,14,83780,55365,0,139145,0
1972,TX,15,64410,53083,0,117493,0
1972,TX,16,75221,41962,0,117183,0
1972,TX,17,104249,37811,0,142060,0
1972,TX,18,34173,62954,0,97127,0
1972,TX,19,145504,34307,0,179811,0
1972,TX,20,36907,56713,0,93620,0
1972,TX,21,121423,38093,0,159516,0
1972,TX,22,94187,52395,0,146582,0
1972,TX,23,71812,44358,0,116170,0
1972,TX,24,91867,54150,0,146017,0
1972,UT,1,166517,50225,0,216742,0
1972,UT,2,157126,76059,0,233185,0
1972,VT,AL,117149,68174,1594,186917,1594
1972,VA,1,95400,43069,3095,141564,3095
1972,VA,2,73728,35107,3222,112057,3222
1972,VA,3,117472,44566,2336,164374,2336
1972,VA,4,85780,45346,3877,135003,3877
1972,VA,5,101546,39194,2959,143699,2959
1972,VA,6,104443,35356,3853,143652,3853
1972,VA,7,101512,38814,2713,143039,2713
1972,VA,8,97923,47747,2093,147763,2093
1972,VA,9,95065,44540,2747,142352,2747
1972,VA,10,115664,65148,2744,183556,2744
1972,WA,1,137563,97967,0,235530,0
1972,WA,2,121349,75728,0,197077,0
1972,WA,3,112130,82747,0,194877,0
1972,WA,4,112728,77042,0,189770,0
1972,WA,5,126627,72966,0,199593,0
1972,WA,6,115377,75698,0,191075,0
1972,WA,7,111127,85891,0,197018,0
1972,WV,1,126902,70735,0,197637,0
1972,WV,2,124917,66597,0,191514,0
1972,WV,3,122907,74219,0,197126,0
1972,WV,4,110238,65884,0,176122,0
1972,WI,1,111281,77321,0,188602,0
1972,WI,2,108506,111508,0,220014,0
1972,WI,3,122445,85348,0,207793,0
1972,WI,4,96755,99537,0,196292,0
1972,WI,5,71196,97596,0,168792,0
1972,WI,6,114461,85778,0,200239,0
1972,WI,7,110826,98230,0,209056,0
1972,WI,8,122672,76912,0,199584,0
1972,WI,9,131288,77944,0,209232,0
1972,WY,AL,100464,44358,748,145570,748
1976,AL,1,83622,81012,0,164634,0
1976,AL,2,75528,88208,0,163736,0
1976,AL,3,63819,93766,0,157585,0
1976,AL,4,66263,124601,0,190864,0
1976,AL,5,50039,106191,0,156230,0
1976,AL,6,90928,70995,0,161923,0
1976,AL,7,71799,93693,0,165492,0
1976,AK,AL,71555,44058,7961,123574,7961
1976,AZ,1,99375,62632,0,162007,0
1976,AZ,2,91113,85224,0,176337,0
1976,AZ,3,111116,74467,0,185583,0
1976,AZ,4,116475,72578,0,189053,0
1976,AR,1,52491,120799,160,173450,160
1976,AR,2,60457,126790,305,187552,305
1976,AR,3,100086,129505,446,230037,446
1976,AR,4,55719,122520,118,178357,118
1976,CA,1,106842,110186,0,217028,0
1976,CA,2,106197,111043,0,217240,0
1976,CA,3,98706,110313,0,209019,0
1976,CA,4,76230,96028,0,172258,0
1976,CA,5,95721,94329,0,190050,0
1976,CA,6,62223,83668,0,145891,0
1976,CA,7,95241,104664,0,199905,0
1976,CA,8,79368,115361,0,194729,0
1976,CA,9,72063,91871,0,163934,0
1976,CA,10,65121,92239,0,157360,0
1976,CA,11,94646,85027,0,179673,0
1976,CA,12,103233,89818,0,193051,0
1976,CA,13,108664,91620,0,200284,0
1976,CA,14,92163,92328,0,184491,0
1976,CA,15,66972,81797,0,148769,0
1976,CA,16,97003,95482,0,192485,0
1976,CA,17,87145,75605,0,162750,0
1976,CA,18,89166,70093,0,159259,0
1976,CA,19,98614,95297,0,193911,0
1976,CA,20,129113,86610,0,215723,0
1976,CA,21,73773,71648,0,145421,0
1976,CA,22,115685,71648,0,187333,0
1976,CA,23,106129,119138,0,225267,0
1976,CA,24,74042,93650,0,167692,0
1976,CA,25,30106,52234,0,82340,0
1976,CA,26,108532,66151,0,174683,0
1976,CA,27,125254,82854,0,208108,0
1976,CA,28,42972,104135,0,147107,0
1976,CA,29,19596,83291,0,102887,0
1976,CA,30,46152,69424,0,115576,0
1976,CA,31,38052,72775,0,110827,0
1976,CA,32,58147,72386,0,130533,0
1976,CA,33,99127,75709,0,174836,0
1976,CA,34,112251,84977,0,197228,0
1976,CA,35,90929,72664,0,163593,0
1976,CA,36,64801,82538,0,147339,0
1976,CA,37,101935,84725,0,186660,0
1976,CA,38,85873,67994,0,153867,0
1976,CA,39,131577,73263,0,204840,0
1976,CA,40,167203,79649,0,246852,0
1976,CA,41,122469,90795,0,213264,0
1976,CA,42,62460,69939,0,132399,0
1976,CA,43,159790,106706,0,266496,0
1976,CO,1,93723,93764,0,187487,0
1976,CO,2,137501,100538,0,238039,0
1976,CO,3,88106,84783,0,172889,0
1976,CO,4,130713,93021,0,223734,0
1976,CO,5,124534,82313,0,206847,0
1976,CT,1,108585,120874,3921,233380,3921
1976,CT,2,110616,111161,3666,225443,3666
1976,CT,3,121685,105602,2809,230096,2809
1976,CT,4,118716,91058,2593,212367,2593
1976,CT,5,133654,104081,2883,240618,2883
1976,CT,6,126005,115119,3327,244451,3327
1976,DE,AL,109831,122596,3082,235509,3082
1976,DC,AL,27873,137818,3139,168830,3139
1976,FL,1,91674,89170,0,180844,0
1976,FL,2,71806,120425,0,192231,0
1976,FL,3,48756,87760,0,136516,0
1976,FL,4,100991,115332,0,216323,0
1976,FL,5,126229,125649,0,251878,0
1976,FL,6,118337,115795,0,234132,0
1976,FL,7,74570,88612,0,163182,0
1976,FL,8,103271,93597,0,196868,0
1976,FL,9,95392,82809,0,178201,0
1976,FL,10,146879,122899,0,269778,0
1976,FL,11,130829,128416,0,259245,0
1976,FL,12,97867,112477,0,210344,0
1976,FL,13,65888,130805,0,196693,0
1976,FL,14,58863,76357,0,135220,0
1976,FL,15,91053,108295,0,199348,0
1976,GA,1,49282,88992,0,138274,0
1976,GA,2,39456,88250,0,127706,0
1976,GA,3,36878,82639,0,119517,0
1976,GA,4,70912,94920,0,165832,0
1976,GA,5,47204,98102,0,145306,0
1976,GA,6,51181,106430,0,157611,0
1976,GA,7,56820,102093,0,158913,0
1976,GA,8,37348,110789,0,148137,0
1976,GA,9,48169,117461,0,165630,0
1976,GA,10,46493,89733,0,136226,0
1976,HI,1,67234,65337,0,132571,0
1976,HI,2,72769,82018,0,154787,0
1976,ID,1,101793,68459,0,170252,0
1976,ID,2,102358,58090,0,160448,0
1976,IL,1,13817,130882,0,144699,0
1976,IL,2,28498,137384,0,165882,0
1976,IL,3,121448,88240,0,209688,0
1976,IL,4,131038,80530,0,211568,0
1976,IL,5,57147,113899,0,171046,0
1976,IL,6,116398,78144,0,194542,0
1976,IL,7,21836,91956,0,113792,0
1976,IL,8,43152,100266,0,143418,0
1976,IL,9,77057,105493,0,182550,0
1976,IL,10,138449,89608,0,228057,0
1976,IL,11,111064,103637,0,214701,0
1976,IL,12,157389,70460,0,227849,0
1976,IL,13,109215,64623,0,173838,0
1976,IL,14,168314,68222,0,236536,0
1976,IL,15,115849,78766,0,194615,0
1976,IL,16,108790,76448,0,185238,0
1976,IL,17,110999,88195,0,199194,0
1976,IL,18,113592,88371,0,201963,0
1976,IL,19,105234,90524,0,195758,0
1976,IL,20,99738,89300,0,189038,0
1976,IL,21,106554,85545,0,192099,0
1976,IL,22,111465,104967,0,216432,0
1976,IL,23,69486,100616,0,170102,0
1976,IL,24,109391,127696,0,237087,0
1976,IN,1,68428,108388,0,176816,0
1976,IN,2,118603,76951,0,195554,0
1976,IN,3,98139,84017,0,182156,0
1976,IN,4,118239,79908,0,198147,0
1976,IN,5,119475,89307,0,208782,0
1976,IN,6,113083,80098,0,193181,0
1976,IN,7,111589,100362,0,211951,0
1976,IN,8,110108,110693,0,220801,0
1976,IN,9,101335,105561,0,206896,0
1976,IN,10,105448,86375,0,191823,0
1976,IN,11,104572,86916,0,191488,0
1976,IA,1,105060,104675,0,209735,0
1976,IA,2,103383,101530,0,204913,0
1976,IA,3,108563,101443,0,210006,0
1976,IA,4,98765,116438,0,215203,0
1976,IA,5,107605,103483,0,211088,0
1976,IA,6,109482,92362,0,201844,0
1976,KS,1,106533,91355,0,197888,0
1976,KS,2,97156,78881,0,176037,0
1976,KS,3,110829,79674,0,190503,0
1976,KS,4,89201,85681,0,174882,0
1976,KS,5,95763,92164,0,187927,0
1976,KY,1,55462,110686,0,166148,0
1976,KY,2,65476,81529,0,147005,0
1976,KY,3,63690,79407,0,143097,0
1976,KY,4,104266,77963,0,182229,0
1976,KY,5,97001,73330,0,170331,0
1976,KY,6,77765,88195,0,165960,0
1976,KY,7,66890,104213,0,171103,0
1976,LA,1,78928,83061,0,161989,0
1976,LA,2,54014,67964,0,121978,0
1976,LA,3,92277,76664,0,168941,0
1976,LA,4,78365,66125,0,144490,0
1976,LA,5,84131,81204,0,165335,0
1976,LA,6,74781,90224,0,165005,0
1976,LA,7,65387,101186,0,166573,0
1976,LA,8,59137,94900,0,154037,0
1976,ME,1,127019,123598,1281,251898,1281
1976,ME,2,109301,108681,2214,220196,2214
1976,MD,1,87481,85106,0,172587,0
1976,MD,2,109176,101830,0,211006,0
1976,MD,3,78442,83341,0,161783,0
1976,MD,4,86352,86532,0,172884,0
1976,MD,5,58086,82660,0,140746,0
1976,MD,6,112380,92682,0,205062,0
1976,MD,7,22795,101341,0,124136,0
1976,MD,8,117949,126116,0,244065,0
1976,MA,1,88051,124082,8060,220193,8060
1976,MA,2,74953,116752,5353,197058,5353
1976,MA,3,80584,125445,6014,212043,6014
1976,MA,4,88613,117919,6975,213507,6975
1976,MA,5,87340,125892,6553,219785,6553
1976,MA,6,97834,119963,8066,225863,8066
1976,MA,7,86572,126935,7981,221488,7981
1976,MA,8,62247,117446,9428,189121,9428
1976,MA,9,69631,90048,5965,165644,5965
1976,MA,10,95210,118890,6882,220982,6882
1976,MA,11,80004,113549,7350,200903,7350
1976,MA,12,119237,132604,9144,260985,9144
1976,MI,1,12618,121815,0,134433,0
1976,MI,2,109460,90984,0,200444,0
1976,MI,3,119812,80137,0,199949,0
1976,MI,4,111830,77086,0,188916,0
1976,MI,5,141655,67423,0,209078,0
1976,MI,6,120079,84753,0,204832,0
1976,MI,7,84998,93377,0,178375,0
1976,MI,8,105159,84198,0,189357,0
1976,MI,9,139170,78084,0,217254,0
1976,MI,10,129329,90223,0,219552,0
1976,MI,11,103331,98653,0,201984,0
1976,MI,12,104379,87787,0,192166,0
1976,MI,13,10654,82895,0,93549,0
1976,MI,14,87498,82896,0,170394,0
1976,MI,15,81619,91412,0,173031,0
1976,MI,16,75048,93021,0,168069,0
1976,MI,17,87946,87311,0,175257,0
1976,MI,18,109551,93705,0,203256,0
1976,MI,19,132349,76909,0,209258,0
1976,MN,1,117565,120286,0,237851,0
1976,MN,2,123435,125615,0,249050,0
1976,MN,3,124439,120201,0,244640,0
1976,MN,4,85922,133051,0,218973,0
1976,MN,5,76940,134503,0,211443,0
1976,MN,6,104667,140420,0,245087,0
1976,MN,7,102502,135192,0,237694,0
1976,MN,8,83325,161172,0,244497,0
1976,MS,1,56974,91615,3929,152518,3929
1976,MS,2,61510,69152,4643,135305,4643
1976,MS,3,82515,79021,3391,164927,3391
1976,MS,4,86002,70260,4293,160555,4293
1976,MS,5,80024,71261,4953,156238,4953
1976,MO,1,38903,95153,0,134056,0
1976,MO,2,124204,95108,0,219312,0
1976,MO,3,90574,85741,0,176315,0
1976,MO,4,100517,108477,0,208994,0
1976,MO,5,60538,87965,0,148503,0
1976,MO,6,99618,107977,0,207595,0
1976,MO,7,114881,103297,0,218178,0
1976,MO,8,105449,93354,0,198803,0
1976,MO,9,109684,108189,0,217873,0
1976,MO,10,80655,108223,0,188878,0
1976,MT,1,90124,77885,2951,170960,2951
1976,MT,2,83579,71374,2821,157774,2821
1976,NE,1,117185,82580,4479,204244,4479
1976,NE,2,115237,76075,4330,195642,4330
1976,NE,3,127283,75037,5462,207782,5462
1976,NV,AL,101273,92479,8124,201876,8124
1976,NH,1,95003,72778,3039,170820,3039
1976,NH,2,90932,74857,3005,168794,3005
1976,NJ,1,82661,112500,0,195161,0
1976,NJ,2,120914,123144,0,244058,0
1976,NJ,3,118767,93283,0,212050,0
1976,NJ,4,83561,97112,0,180673,0
1976,NJ,5,128276,88004,0,216280,0
1976,NJ,6,115807,108251,0,224058,0
1976,NJ,7,129847,93764,0,223611,0
1976,NJ,8,86402,79546,0,165948,0
1976,NJ,9,116058,96933,0,212991,0
1976,NJ,10,31267,82612,0,113879,0
1976,NJ,11,104088,98038,0,202126,0
1976,NJ,12,106127,91007,0,197134,0
1976,NJ,13,127723,87608,0,215331,0
1976,NJ,14,70173,91375,0,161548,0
1976,NJ,15,87830,101616,0,189446,0
1976,NM,1,116334,113197,2344,231875,2344
1976,NM,2,95085,87951,1679,184715,1679
1976,NY,1,117277,98409,0,215686,0
1976,NY,2,90243,75033,0,165276,0
1976,NY,3,105322,88901,0,194223,0
1976,NY,4,103663,98788,0,202451,0
1976,NY,5,107909,100782,0,208691,0
1976,NY,6,99497,97676,0,197173,0
1976,NY,7,35888,98095,0,133983,0
1976,NY,8,52024,104158,0,156182,0
1976,NY,9,75415,63412,0,138827,0
1976,NY,10,56741,75681,0,132422,0
1976,NY,11,39937,93240,0,133177,0
1976,NY,12,10513,49550,0,60063,0
1976,NY,13,44176,112044,0,156220,0
1976,NY,14,17735,63370,0,81105,0
1976,NY,15,62787,62332,0,125119,0
1976,NY,16,35378,88016,0,123394,0
1976,NY,17,68723,83301,0,152024,0
1976,NY,18,63441,108478,0,171919,0
1976,NY,19,14642,99111,0,113753,0
1976,NY,20,32250,105995,0,138245,0
1976,NY,21,4677,45749,0,50426,0
1976,NY,22,29723,96891,0,126614,0
1976,NY,23,82078,90623,0,172701,0
1976,NY,24,101668,90302,0,191970,0
1976,NY,25,118585,86387,0,204972,0
1976,NY,26,106176,92098,0,198274,0
1976,NY,27,108821,88806,0,197627,0
1976,NY,28,113853,107602,0,221455,0
1976,NY,29,136099,87311,0,223410,0
1976,NY,30,104841,75006,0,179847,0
1976,NY,31,107363,84661,0,192024,0
1976,NY,32,117652,75658,0,193310,0
1976,NY,33,115166,75263,0,190429,0
1976,NY,34,112816,87580,0,200396,0
1976,NY,35,111399,85502,0,196901,0
1976,NY,36,102268,88063,0,190331,0
1976,NY,37,55021,95413,0,150434,0
1976,NY,38,122219,98494,0,220713,0
1976,NY,39,106803,77776,0,184579,0
1976,NC,1,52752,79503,0,132255,0
1976,NC,2,51543,81050,0,132593,0
1976,NC,3,48186,68612,0,116798,0
1976,NC,4,81852,85541,0,167393,0
1976,NC,5,89368,92010,0,181378,0
1976,NC,6,67483,77610,0,145093,0
1976,NC,7,40560,81207,0,121767,0
1976,NC,8,69653,85084,0,154737,0
1976,NC,9,79970,85955,0,165925,0
1976,NC,10,76532,90939,0,167471,0
1976,NC,11,84061,99854,0,183915,0
1976,ND,AL,153470,136078,7218,296766,7218
1976,OH,1,98225,69422,0,167647,0
1976,OH,2,103650,62649,0,166299,0
1976,OH,3,74128,78920,0,153048,0
1976,OH,4,104313,70588,0,174901,0
1976,OH,5,104089,83692,0,187781,0
1976,OH,6,91352,86984,0,178336,0
1976,OH,7,86785,75152,0,161937,0
1976,OH,8,92736,77534,0,170270,0
1976,OH,9,68409,96812,0,165221,0
1976,OH,10,96410,92461,0,188871,0
1976,OH,11,83674,92298,0,175972,0
1976,OH,12,106103,84624,0,190727,0
1976,OH,13,79351,94309,0,173660,0
1976,OH,14,61167,103094,0,164261,0
1976,OH,15,99460,68995,0,168455,0
1976,OH,16,90463,83776,0,174239,0
1976,OH,17,92350,78041,0,170391,0
1976,OH,18,86513,106448,0,192961,0
1976,OH,19,69063,112185,0,181248,0
1976,OH,20,50457,83949,0,134406,0
1976,OH,21,17904,107813,0,125717,0
1976,OH,22,100076,99195,0,199271,0
1976,OH,23,110590,84525,0,195115,0
1976,OK,1,114485,71288,0,185773,0
1976,OK,2,86067,101406,0,187473,0
1976,OK,3,66439,117459,0,183898,0
1976,OK,4,73168,85429,0,158597,0
1976,OK,5,94535,68288,0,162823,0
1976,OK,6,106437,86542,0,192979,0
1976,OR,1,156920,127470,0,284390,0
1976,OR,2,124596,118067,0,242663,0
1976,OR,3,93855,115564,0,209419,0
1976,OR,4,116717,129306,0,246023,0
1976,PA,1,50923,122695,0,173618,0
1976,PA,2,31264,128921,0,160185,0
1976,PA,3,47471,101997,0,149468,0
1976,PA,4,96820,129639,0,226459,0
1976,PA,5,121190,77048,0,198238,0
1976,PA,6,89194,90203,0,179397,0
1976,PA,7,109441,93411,0,202852,0
1976,PA,8,101845,89991,0,191836,0
1976,PA,9,96867,66499,0,163366,0
1976,PA,10,100938,97659,0,198597,0
1976,PA,11,85292,101571,0,186863,0
1976,PA,12,88382,91237,0,179619,0
1976,PA,13,120746,89823,0,210569,0
1976,PA,14,68088,98609,0,166697,0
1976,PA,15,79821,89134,0,168955,0
1976,PA,16,101642,56814,0,158456,0
1976,PA,17,98920,73061,0,171981,0
1976,PA,18,108001,90062,0,198063,0
1976,PA,19,105544,70417,0,175961,0
1976,PA,20,83713,102730,0,186443,0
1976,PA,21,78965,92450,0,171415,0
1976,PA,22,75161,103041,0,178202,0
1976,PA,23,91276,77474,0,168750,0
1976,PA,24,87411,95138,0,182549,0
1976,PA,25,84138,97466,0,181604,0
1976,RI,1,85061,113522,0,198583,0
1976,RI,2,95702,112877,0,208579,0
1976,SC,1,59939,70124,0,130063,0
1976,SC,2,69827,76948,0,146775,0
1976,SC,3,54640,78296,0,132936,0
1976,SC,4,59555,63848,0,123403,0
1976,SC,5,50328,77715,0,128043,0
1976,SC,6,51860,83876,0,135736,0
1976,SD,1,76758,78684,805,156247,805
1976,SD,2,74747,68384,1300,144431,1300
1976,TN,1,96233,83151,0,179384,0
1976,TN,2,98032,94759,0,192791,0
1976,TN,3,88578,96126,0,184704,0
1976,TN,4,58441,124267,0,182708,0
1976,TN,5,64543,110779,0,175322,0
1976,TN,6,94314,104815,0,199129,0
1976,TN,7,73714,100751,0,174465,0
1976,TN,8,60114,111229,0,171343,0
1976,TX,1,69297,104400,0,173697,0
1976,TX,2,76438,105487,0,181925,0
1976,TX,3,172909,65021,0,237930,0
1976,TX,4,84734,87394,0,172128,0
1976,TX,5,61251,68944,0,130195,0
1976,TX,6,91676,95567,0,187243,0
1976,TX,7,186190,66790,0,252980,0
1976,TX,8,52248,89254,0,141502,0
1976,TX,9,67280,97800,0,165080,0
1976,TX,10,97640,115946,0,213586,0
1976,TX,11,71096,94548,0,165644,0
1976,TX,12,58562,74381,0,132943,0
1976,TX,13,87302,85220,0,172522,0
1976,TX,14,68780,95485,0,164265,0
1976,TX,15,49873,94926,0,144799,0
1976,TX,16,60264,59349,0,119613,0
1976,TX,17,71103,95482,0,166585,0
1976,TX,18,26606,82608,0,109214,0
1976,TX,19,93985,68836,0,162821,0
1976,TX,20,26711,77691,0,104402,0
1976,TX,21,127268,85953,0,213221,0
1976,TX,22,95998,95479,0,191477,0
1976,TX,23,57139,83251,0,140390,0
1976,TX,24,60373,75161,0,135534,0
1976,UT,1,170399,82741,11344,264484,11344
1976,UT,2,167509,99369,9836,276714,9836
1976,VT,AL,102085,81044,725,183854,725
1976,VA,1,75601,80485,4698,160784,4698
1976,VA,2,60261,62494,5737,128492,5737
1976,VA,3,101625,77417,3486,182528,3486
1976,VA,4,62675,89112,4690,156477,4690
1976,VA,5,85224,77285,5856,168365,5856
1976,VA,6,82235,80686,4249,167170,4249
1976,VA,7,96884,79319,4402,180605,4402
1976,VA,8,87858,81501,3860,173219,3860
1976,VA,9,79376,90065,5919,175360,5919
1976,VA,10,104815,92341,3747,200903,3747
1976,WA,1,126588,104738,0,231326,0
1976,WA,2,116274,107031,0,223305,0
1976,WA,3,105441,113587,0,219028,0
1976,WA,4,111182,93783,0,204965,0
1976,WA,5,114988,91796,0,206784,0
1976,WA,6,103846,106107,0,209953,0
1976,WA,7,99388,100271,0,199659,0
1976,WV,1,84374,105377,0,189751,0
1976,WV,2,86234,113392,0,199626,0
1976,WV,3,81613,111688,0,193301,0
1976,WV,4,62505,105407,0,167912,0
1976,WI,1,107457,106274,0,213731,0
1976,WI,2,113143,125639,0,238782,0
1976,WI,3,119607,121904,0,241511,0
1976,WI,4,97686,119386,0,217072,0
1976,WI,5,68240,116332,0,184572,0
1976,WI,6,118126,108920,0,227046,0
1976,WI,7,105666,134210,0,239876,0
1976,WI,8,122174,105904,0,228078,0
1976,WI,9,152888,101663,0,254551,0
1976,WY,AL,92717,62239,1387,156343,1387
1980,AL,1,107659,77758,1969,187386,1969
1980,AL,2,99583,83717,1991,185291,1991
1980,AL,3,81520,90029,2063,173612,2063
1980,AL,4,95402,108327,1627,205356,1627
1980,AL,5,72831,96169,3746,172746,3746
1980,AL,6,104374,82538,3040,189952,3040
1980,AL,7,90008,97158,2004,189170,2004
1980,AK,AL,86112,41842,30491,158445,30491
1980,AZ,1,118001,51119,16390,185510,16390
1980,AZ,2,111164,75694,27721,214579,27721
1980,AZ,3,148411,60656,15468,224535,15468
1980,AZ,4,151495,59841,16784,228120,16784
1980,AR,1,79426,93654,5845,178925,5845
1980,AR,2,95148,103040,9699,207887,9699
1980,AR,3,150405,96831,14080,261316,14080
1980,AR,4,78185,104516,6753,189454,6753
1980,CA,1,158846,88189,22249,269284,22249
1980,CA,2,132531,95971,27869,256371,27869
1980,CA,3,118814,99225,23357,241396,23357
1980,CA,4,103541,86427,20295,210263,20295
1980,CA,5,80930,91480,26904,199314,26904
1980,CA,6,50967,81691,16502,149160,16502
1980,CA,7,113690,90975,21827,226492,21827
1980,CA,8,65088,106500,22813,194401,22813
1980,CA,9,77897,75961,15400,169258,15400
1980,CA,10,78689,71937,18622,169248,18622
1980,CA,11,96108,72391,22081,190580,22081
1980,CA,12,95588,72649,32926,201163,32926
1980,CA,13,121122,73035,29470,223627,29470
1980,CA,14,128907,79120,17939,225966,17939
1980,CA,15,79871,73088,11593,164552,11593
1980,CA,16,116525,79073,25921,221519,25921
1980,CA,17,108148,69479,11492,189119,11492
1980,CA,18,114504,55531,9068,179103,9068
1980,CA,19,119582,72903,22713,215198,22713
1980,CA,20,166697,67044,20802,254543,20802
1980,CA,21,80766,60172,12634,153572,12634
1980,CA,22,116051,56067,13815,185933,13815
1980,CA,23,100601,89053,22521,212175,22521
1980,CA,24,65890,74435,13545,153870,13545
1980,CA,25,27630,44131,5013,76774,5013
1980,CA,26,111196,47638,11573,170407,11573
1980,CA,27,125736,66220,20616,212572,20616
1980,CA,28,36354,102516,7733,146603,7733
1980,CA,29,17564,80696,2255,100515,2255
1980,CA,30,48350,52905,6550,107805,6550
1980,CA,31,39927,68544,5242,113713,5242
1980,CA,32,64967,58065,8728,131760,8728
1980,CA,33,114895,53102,11464,179461,11464
1980,CA,34,123748,58974,15573,198295,15573
1980,CA,35,124297,58017,14318,196632,14318
1980,CA,36,92118,65274,13171,170563,13171
1980,CA,37,149780,69594,14706,234080,14706
1980,CA,38,109167,47995,11375,168537,11375
1980,CA,39,170015,51811,16328,238154,16328
1980,CA,40,225599,68255,24575,318429,24575
1980,CA,41,138300,68347,27803,234450,27803
1980,CA,42,79670,55380,12636,147686,12636
1980,CA,43,232808,83335,28281,344424,28281
1980,CO,1,81924,76017,27046,184987,27046
1980,CO,2,145045,81064,35369,261478,35369
1980,CO,3,106515,68918,13244,188677,13244
1980,CO,4,155774,74714,29035,259523,29035
1980,CO,5,157035,65175,25249,247459,25249
1980,CT,1,89511,105401,35844,230756,35844
1980,CT,2,108219,89252,36541,234012,36541
1980,CT,3,117043,90454,25539,233036,25539
1980,CT,4,110273,76569,22916,209758,22916
1980,CT,5,133228,83705,29462,246395,29462
1980,CT,6,118936,96351,37041,252328,37041
1980,DE,AL,111252,105754,18662,235668,18662
1980,DC,AL,23313,130231,20345,173889,20345
1980,FL,1,126062,99637,4762,230461,4762
1980,FL,2,91349,115951,9141,216441,9141
1980,FL,3,72378,79369,3497,155244,3497
1980,FL,4,149231,104021,8281,261533,8281
1980,FL,5,201043,125344,13042,339429,13042
1980,FL,6,146473,114195,14395,275063,14395
1980,FL,7,100582,82344,8726,191652,8726
1980,FL,8,142061,86314,8614,236989,8614
1980,FL,9,126606,66280,9457,202343,9457
1980,FL,10,241648,115194,15820,372662,15820
1980,FL,11,197972,125797,22713,346482,22713
1980,FL,12,140464,90856,19259,250579,19259
1980,FL,13,79330,95384,15160,189874,15160
1980,FL,14,73790,50720,9211,133721,9211
1980,FL,15,119317,73261,21548,214126,21548
1980,GA,1,61810,79860,2349,144019,2349
1980,GA,2,57604,78073,1363,137040,1363
1980,GA,3,47356,77017,2173,126546,2173
1980,GA,4,81516,93288,7660,182464,7660
1980,GA,5,51201,88548,5883,145632,5883
1980,GA,6,86752,122387,4144,213283,4144
1980,GA,7,85837,90632,4532,181001,4532
1980,GA,8,53197,100073,2068,155338,2068
1980,GA,9,88673,114933,3870,207476,3870
1980,GA,10,60334,83867,3020,147221,3020
1980,HI,1,58045,56298,17067,131410,17067
1980,HI,2,72067,79581,20229,171877,20229
1980,ID,1,141434,66316,16754,224504,16754
1980,ID,2,149265,43876,10304,203445,10304
1980,IL,1,6633,128426,3092,138151,3092
1980,IL,2,20946,145205,3612,169763,3612
1980,IL,3,109179,87091,12594,208864,12594
1980,IL,4,130344,76622,18017,224983,18017
1980,IL,5,44940,106568,6096,157604,6096
1980,IL,6,91766,69003,14505,175274,14505
1980,IL,7,17988,85999,3188,107175,3188
1980,IL,8,32694,97057,5842,135593,5842
1980,IL,9,57063,95175,18346,170584,18346
1980,IL,10,120146,78426,28394,226966,28394
1980,IL,11,91388,95039,14515,200942,14515
1980,IL,12,158516,65143,28616,252275,28616
1980,IL,13,116322,53507,17978,187807,17978
1980,IL,14,182308,68991,29801,281100,29801
1980,IL,15,141134,57919,19477,218530,19477
1980,IL,16,184821,65855,35622,286298,35622
1980,IL,17,120293,72365,12138,204796,12138
1980,IL,18,135243,73463,14381,223087,14381
1980,IL,19,117933,72573,13176,203682,13176
1980,IL,20,169853,104156,13697,287706,13697
1980,IL,21,113029,87652,21996,222677,21996
1980,IL,22,137079,80436,9176,226691,9176
1980,IL,23,80832,82375,6836,170043,6836
1980,IL,24,131012,89611,8745,229368,8745
1980,IN,1,68293,90663,6357,165313,6357
1980,IN,2,146550,66410,14348,227308,14348
1980,IN,3,122484,88535,14122,225141,14122
1980,IN,4,125737,70264,15859,211860,15859
1980,IN,5,127587,63911,9496,200994,9496
1980,IN,6,123538,64836,8513,196887,8513
1980,IN,7,113098,73774,10263,197135,10263
1980,IN,8,124107,98026,9788,231921,9788
1980,IN,9,117173,89450,7902,214525,7902
1980,IN,10,132498,80620,10126,223244,10126
1980,IN,11,99256,76146,8781,184183,8781
1980,IA,1,105371,97431,22218,225020,22218
1980,IA,2,106149,85681,20023,211853,20023
1980,IA,3,115682,83485,17496,216663,17496
1980,IA,4,105520,98326,21354,225200,21354
1980,IA,5,122135,77523,19660,219318,19660
1980,IA,6,121169,71226,14882,207277,14882
1980,KS,1,134777,53845,11995,200617,11995
1980,KS,2,102325,62464,13040,177829,13040
1980,KS,3,112391,70039,18272,200702,18272
1980,KS,4,109579,74935,15799,200313,15799
1980,KS,5,115495,68847,9894,194236,9894
1980,KY,1,81192,101091,2500,184783,2500
1980,KY,2,88017,82335,3142,173494,3142
1980,KY,3,56932,80370,4882,142184,4882
1980,KY,4,116003,78914,7501,202418,7501
1980,KY,5,121708,75712,2581,200001,2581
1980,KY,6,89167,93179,8063,190409,8063
1980,KY,7,81842,104596,2409,188847,2409
1980,LA,1,100436,90636,3794,194866,3794
1980,LA,2,63625,75187,3527,142339,3527
1980,LA,3,124949,74724,4422,204095,4422
1980,LA,4,96750,78745,1945,177440,1945
1980,LA,5,107171,81524,1628,190323,1628
1980,LA,6,109692,101252,4353,215297,4353
1980,LA,7,103149,98122,4200,205471,4200
1980,LA,8,89730,105241,2476,197447,2476
1980,ME,1,126274,117613,36321,280208,36321
1980,ME,2,112248,103361,26603,242212,26603
1980,MD,1,104227,83894,13132,201253,13132
1980,MD,2,103501,102508,21315,227324,21315
1980,MD,3,59589,87965,12144,159698,12144
1980,MD,4,94648,80702,15225,190575,15225
1980,MD,5,55344,71759,13117,140220,13117
1980,MD,6,128716,86833,20254,235803,20254
1980,MD,7,14103,111554,4927,130584,4927
1980,MD,8,120478,100946,33615,255039,33615
1980,MA,1,85268,93495,38162,216925,38162
1980,MA,2,81460,83305,28576,193341,28576
1980,MA,3,86737,90169,31627,208533,31627
1980,MA,4,83686,88488,37071,209245,37071
1980,MA,5,97018,86302,35531,218851,35531
1980,MA,6,97969,86256,41028,225253,41028
1980,MA,7,90726,91189,32908,214823,32908
1980,MA,8,56312,92707,31850,180869,31850
1980,MA,9,64451,73906,23445,161802,23445
1980,MA,10,98381,87030,37262,222673,37262
1980,MA,11,84624,82538,27438,194600,27438
1980,MA,12,130999,98427,47967,277393,47967
1980,MI,1,5867,112907,1402,120176,1402
1980,MI,2,100535,82977,20055,203567,20055
1980,MI,3,116500,78228,20525,215253,20525
1980,MI,4,122398,66802,11786,200986,11786
1980,MI,5,127736,81566,19696,228998,19696
1980,MI,6,114648,84771,24499,223918,24499
1980,MI,7,84272,94837,12829,191938,12829
1980,MI,8,112243,85019,13473,210735,13473
1980,MI,9,140514,76224,14592,231330,14592
1980,MI,10,136702,87373,19644,243719,19644
1980,MI,11,121678,101478,15857,239013,15857
1980,MI,12,123619,86172,15321,225112,15321
1980,MI,13,5090,73593,1113,79796,1113
1980,MI,14,79304,72151,9686,161141,9686
1980,MI,15,89981,86621,11832,188434,11832
1980,MI,16,76947,79784,10813,167544,10813
1980,MI,17,72582,89835,11878,174295,11878
1980,MI,18,101004,85575,15430,202009,15430
1980,MI,19,156066,83506,21232,260804,21232
1980,MN,1,118530,107960,21763,248253,21763
1980,MN,2,134627,103035,22119,259781,22119
1980,MN,3,118227,113429,27630,259286,27630
1980,MN,4,78432,124166,23081,225679,23081
1980,MN,5,63830,123562,26750,214142,26750
1980,MN,6,131735,107458,18627,257820,18627
1980,MN,7,132532,108610,16496,257638,16496
1980,MN,8,92565,148783,18524,259872,18524
1980,MS,1,74191,97730,5003,176924,5003
1980,MS,2,70194,79717,3600,153511,3600
1980,MS,3,98438,91930,4472,194840,4472
1980,MS,4,94921,88623,4781,188325,4781
1980,MS,5,103345,71281,4394,179020,4394
1980,MO,1,31649,95628,5092,132369,5092
1980,MO,2,127456,91777,12813,232046,12813
1980,MO,3,94637,81774,8191,184602,8191
1980,MO,4,118144,96968,7558,222670,7558
1980,MO,5,56925,94512,8166,159603,8166
1980,MO,6,112712,93933,8233,214878,8233
1980,MO,7,146971,88807,6335,242113,6335
1980,MO,8,129726,89284,8568,227578,8568
1980,MO,9,136104,100392,7930,244426,7930
1980,MO,10,113704,95288,4561,213553,4561
1980,MT,1,107574,64393,22502,194469,22502
1980,MT,2,99240,53639,16604,169483,16604
1980,NE,1,133971,59729,20603,214303,20603
1980,NE,2,124810,61448,18645,204903,18645
1980,NE,3,160433,45247,14818,220498,14818
1980,NV,AL,155017,66666,26202,247885,26202
1980,NH,1,116597,53069,25091,194757,25091
1980,NH,2,105108,55795,28271,189174,28271
1980,NJ,1,92376,84465,16867,193708,16867
1980,NJ,2,141464,94184,17210,252858,17210
1980,NJ,3,130961,76116,18440,225517,18440
1980,NJ,4,84103,78828,14056,176987,14056
1980,NJ,5,122338,70704,22523,215565,22523
1980,NJ,6,131054,83224,20606,234884,20606
1980,NJ,7,126536,71849,21619,220004,21619
1980,NJ,8,84715,65102,9487,159304,9487
1980,NJ,9,117284,74822,17373,209479,17373
1980,NJ,10,22261,73860,3490,99611,3490
1980,NJ,11,95919,77094,16689,189702,16689
1980,NJ,12,100488,73083,14244,187815,14244
1980,NJ,13,138364,65847,22042,226253,22042
1980,NJ,14,65713,76679,6595,148987,6595
1980,NJ,15,93625,82203,13402,189230,13402
1980,NM,1,130017,97809,27294,255120,27294
1980,NM,2,120762,70011,10338,201111,10338
1980,NY,1,124331,71530,17756,213617,17756
1980,NY,2,91682,52068,10830,154580,10830
1980,NY,3,106282,63346,14895,184523,14895
1980,NY,4,111230,61754,15925,188909,15925
1980,NY,5,101877,74302,11418,187597,11418
1980,NY,6,99905,65996,14497,180398,14497
1980,NY,7,41376,83385,6466,131227,6466
1980,NY,8,59336,65394,9635,134365,9635
1980,NY,9,68036,46748,6338,121122,6338
1980,NY,10,50178,58412,4545,113135,4545
1980,NY,11,46990,60006,5576,112572,5576
1980,NY,12,8053,42296,873,51222,873
1980,NY,13,56174,55336,6630,118140,6630
1980,NY,14,14678,54693,3196,72567,3196
1980,NY,15,55958,46323,5583,107864,5583
1980,NY,16,39344,55813,5091,100248,5091
1980,NY,17,77171,66823,11212,155206,11212
1980,NY,18,62395,81679,18814,162888,18814
1980,NY,19,12230,84912,5685,102827,5685
1980,NY,20,32400,80488,10921,123809,10921
1980,NY,21,3632,38723,639,42994,639
1980,NY,22,28497,65030,4726,98253,4726
1980,NY,23,86064,69720,11381,167165,11381
1980,NY,24,93482,68665,15004,177151,15004
1980,NY,25,123585,65194,19108,207887,19108
1980,NY,26,115806,67593,16898,200297,16898
1980,NY,27,95553,75875,21960,193388,21960
1980,NY,28,87685,107364,22429,217478,22429
1980,NY,29,139037,85606,19770,244413,19770
1980,NY,30,71290,60596,11598,143484,11598
1980,NY,31,97430,76945,13370,187745,13370
1980,NY,32,99311,71354,19834,190499,19834
1980,NY,33,117783,84240,19941,221964,19941
1980,NY,34,82867,89911,19877,192655,19877
1980,NY,35,92312,88564,15181,196057,15181
1980,NY,36,82409,82183,14001,178593,14001
1980,NY,37,35230,90367,7036,132633,7036
1980,NY,38,101559,92435,16489,210483,16489
1980,NY,39,97773,67886,12049,177708,12049
1980,NC,1,72369,81472,3293,157134,3293
1980,NC,2,60686,80482,4872,146040,4872
1980,NC,3,63559,67875,1993,133427,1993
1980,NC,4,94339,91223,9551,195113,9551
1980,NC,5,104622,83043,4510,192175,4510
1980,NC,6,82573,71266,5242,159081,5242
1980,NC,7,58352,73710,3175,135237,3175
1980,NC,8,88044,75483,3515,167042,3515
1980,NC,9,92319,86858,7483,186660,7483
1980,NC,10,97286,75087,3802,176175,3802
1980,NC,11,100868,89129,5364,195361,5364
1980,ND,AL,193695,79189,28661,301545,28661
1980,OH,1,92741,65224,8441,166406,8441
1980,OH,2,102455,58471,8141,169067,8141
1980,OH,3,72684,77380,10151,160215,10151
1980,OH,4,127002,59722,9408,196132,9408
1980,OH,5,144298,79455,18840,242593,18840
1980,OH,6,75109,54904,4431,134444,4431
1980,OH,7,93553,67916,10048,171517,10048
1980,OH,8,111538,72266,9392,193196,9392
1980,OH,9,75323,77661,14808,167792,14808
1980,OH,10,111879,79778,8459,200116,8459
1980,OH,11,103188,79137,13683,196008,13683
1980,OH,12,130096,90046,11727,231869,11727
1980,OH,13,98962,76045,13483,188490,13483
1980,OH,14,68533,85860,12091,166484,12091
1980,OH,15,98309,66596,11589,176494,11589
1980,OH,16,107794,71727,10413,189934,10413
1980,OH,17,111025,64651,9693,185369,9693
1980,OH,18,88934,82803,9113,180850,9113
1980,OH,19,76152,94213,13709,184074,13709
1980,OH,20,52322,66223,7623,126168,7623
1980,OH,21,12299,97071,2982,112352,2982
1980,OH,22,92016,84318,15896,192230,15896
1980,OH,23,108387,67942,14714,191043,14714
1980,OK,1,131916,58023,8153,198092,8153
1980,OK,2,114382,86877,4993,206252,4993
1980,OK,3,92410,92068,3213,187691,3213
1980,OK,4,92255,61329,2252,155836,2252
1980,OK,5,109429,47118,7367,163914,7367
1980,OK,6,139828,54898,6618,201344,6618
1980,OR,1,157902,123866,38527,320295,38527
1980,OR,2,162094,106767,25713,294574,25713
1980,OR,3,96529,113273,23902,233704,23902
1980,OR,4,154512,112973,24246,291731,24246
1980,PA,1,53279,105609,8019,166907,8019
1980,PA,2,21639,130678,6547,158864,6547
1980,PA,3,46147,86220,8349,140716,8349
1980,PA,4,107919,86344,17354,211617,17354
1980,PA,5,129775,61107,17512,208394,17512
1980,PA,6,100019,65269,12240,177528,12240
1980,PA,7,106145,69706,15100,190951,15100
1980,PA,8,113286,64923,20046,198255,20046
1980,PA,9,103879,54609,7365,165853,7365
1980,PA,10,107138,76453,10026,193617,10026
1980,PA,11,95365,80780,7605,183750,7605
1980,PA,12,90454,81947,6857,179258,6857
1980,PA,13,117873,67702,20575,206150,20575
1980,PA,14,54736,92226,10389,157351,10389
1980,PA,15,86569,66747,15800,169116,15800
1980,PA,16,114815,46372,11419,172606,11419
1980,PA,17,99371,56250,10704,166325,10704
1980,PA,18,98677,81406,13168,193251,13168
1980,PA,19,111265,58003,11851,181119,11851
1980,PA,20,77245,90546,9878,177669,9878
1980,PA,21,81193,85062,8341,174596,8341
1980,PA,22,73735,92829,7156,173720,7156
1980,PA,23,93731,65211,10986,169928,10986
1980,PA,24,87842,77440,11691,176973,11691
1980,PA,25,83765,87982,10690,182437,10690
1980,RI,1,72958,96087,28689,197734,28689
1980,RI,2,81519,101008,30677,213204,30677
1980,SC,1,85007,70615,4567,160189,4567
1980,SC,2,84238,73184,5036,162458,5036
1980,SC,3,70344,73328,3260,146932,3260
1980,SC,4,76260,59380,3644,139284,3644
1980,SC,5,59014,71376,2548,132938,2548
1980,SC,6,66343,79676,2285,148304,2285
1980,SD,1,95170,59684,15113,169967,15113
1980,SD,2,103173,44171,10392,157736,10392
1980,TN,1,120203,70930,6330,197463,6330
1980,TN,2,119853,79572,7813,207238,7813
1980,TN,3,113363,82568,5420,201351,5420
1980,TN,4,85714,118789,5078,209581,5078
1980,TN,5,76628,114893,6404,197925,6404
1980,TN,6,123782,101836,6871,232489,6871
1980,TN,7,102092,96419,4394,202905,4394
1980,TN,8,51121,118094,4494,173709,4494
1980,TX,1,96685,99203,1580,197468,1580
1980,TX,2,111165,107327,3209,221701,3209
1980,TX,3,210633,65755,10379,286767,10379
1980,TX,4,117540,80643,3415,201598,3415
1980,TX,5,75323,64706,3477,143506,3477
1980,TX,6,113504,90893,4623,209020,4623
1980,TX,7,220530,64386,11344,296260,11344
1980,TX,8,62813,72601,2722,138136,2722
1980,TX,9,85646,88418,4328,178392,4328
1980,TX,10,112687,107406,11428,231521,11428
1980,TX,11,101035,84009,4126,189170,4126
1980,TX,12,82561,72992,3401,158954,3401
1980,TX,13,113453,64474,3021,180948,3021
1980,TX,14,87979,80040,3406,171425,3406
1980,TX,15,67517,89487,2464,159468,2464
1980,TX,16,74138,51743,5565,131446,5565
1980,TX,17,95818,77774,1992,175584,1992
1980,TX,18,23051,67361,2613,93025,2613
1980,TX,19,122673,48082,3461,174216,3461
1980,TX,20,22903,79282,2002,104187,2002
1980,TX,21,156904,80296,5978,243178,5978
1980,TX,22,118063,81843,6308,206214,6308
1980,TX,23,74449,75143,2734,152326,2734
1980,TX,24,78005,72013,3714,153732,3714
1980,UT,1,236439,56592,13582,306613,13582
1980,UT,2,203248,67674,26687,297609,26687
1980,VT,AL,94598,81891,36718,213207,36718
1980,VA,1,88022,77510,9753,175285,9753
1980,VA,2,71129,57164,10323,138616,10323
1980,VA,3,109864,78826,10101,198791,10101
1980,VA,4,76999,84300,6879,168178,6879
1980,VA,5,106318,74486,7227,188031,7227
1980,VA,6,96026,74842,9027,179895,9027
1980,VA,7,117538,74608,12952,205098,12952
1980,VA,8,113676,67754,22289,203719,22289
1980,VA,9,89709,86013,7630,183352,7630
1980,VA,10,120328,76676,28068,225072,28068
1980,WA,1,107925,97899,35829,241653,35829
1980,WA,2,138265,101857,29902,270024,29902
1980,WA,3,133405,101699,26864,261968,26864
1980,WA,4,131717,85906,19219,236842,19219
1980,WA,5,132936,80554,18973,232463,18973
1980,WA,6,123867,88831,28621,241319,28621
1980,WA,7,97129,93447,25665,216241,25665
1980,WV,1,85216,88697,9626,183539,9626
1980,WV,2,93228,94094,10637,197959,10637
1980,WV,3,88693,91695,9787,190175,9787
1980,WV,4,67069,92976,5997,166042,5997
1980,WI,1,115995,97626,16233,229854,16233
1980,WI,2,110374,123451,25815,259640,25815
1980,WI,3,130635,116758,19528,266921,19528
1980,WI,4,99267,108816,15912,223995,15912
1980,WI,5,61322,117147,13972,192441,13972
1980,WI,6,131522,98007,15707,245236,15707
1980,WI,7,123451,124011,16805,264267,16805
1980,WI,8,146595,96188,15293,258076,15293
1980,WI,9,167884,97580,21392,286856,21392
1980,WY,AL,110700,49427,16586,176713,16586
1984,AL,1,134551,72298,0,206849,0
1984,AL,2,130370,73603,0,203973,0
1984,AL,3,113641,70024,0,183665,0
1984,AL,4,118750,80187,0,198937,0
1984,AL,5,119034,80039,0,199073,0
1984,AL,6,130184,89841,0,220025,0
1984,AL,7,126319,85907,0,212226,0
1984,AK,AL,138377,62007,7221,207605,7221
1984,AZ,1,154845,58492,0,213337,0
1984,AZ,2,71001,66596,0,137597,0
1984,AZ,3,156030,60382,0,216412,0
1984,AZ,4,155112,61600,0,216712,0
1984,AZ,5,144428,86784,0,231212,0
1984,AR,1,114091,86741,0,200832,0
1984,AR,2,133093,87447,0,220540,0
1984,AR,3,165217,69974,0,235191,0
1984,AR,4,122373,94484,0,216857,0
1984,CA,1,134358,119330,0,253688,0
1984,CA,2,150641,83085,0,233726,0
1984,CA,3,139564,112714,0,252278,0
1984,CA,4,127252,96775,0,224027,0
1984,CA,5,72437,142282,0,214719,0
1984,CA,6,106610,141884,0,248494,0
1984,CA,7,126001,114148,0,240149,0
1984,CA,8,88833,173055,0,261888,0
1984,CA,9,107925,106640,0,214565,0
1984,CA,10,87529,82340,0,169869,0
1984,CA,11,112986,109053,0,222039,0
1984,CA,12,148724,108069,0,256793,0
1984,CA,13,126585,89789,0,216374,0
1984,CA,14,162239,86619,0,248858,0
1984,CA,15,101657,70069,0,171726,0
1984,CA,16,111375,98292,0,209667,0
1984,CA,17,116975,65892,0,182867,0
1984,CA,18,102593,98163,0,200756,0
1984,CA,19,141327,82697,0,224024,0
1984,CA,20,151080,64244,0,215324,0
1984,CA,21,177196,65617,0,242813,0
1984,CA,22,175164,63874,0,239038,0
1984,CA,23,129010,113020,0,242030,0
1984,CA,24,70370,88680,0,159050,0
1984,CA,25,42375,65974,0,108349,0
1984,CA,26,108528,90429,0,198957,0
1984,CA,27,117634,104031,0,221665,0
1984,CA,28,51069,108287,0,159356,0
1984,CA,29,29106,103221,0,132327,0
1984,CA,30,71658,56598,0,128256,0
1984,CA,31,61006,87740,0,148746,0
1984,CA,32,103902,71926,0,175828,0
1984,CA,33,152606,63307,0,215913,0
1984,CA,34,89795,60961,0,150756,0
1984,CA,35,154583,59824,0,214407,0
1984,CA,36,103809,80504,0,184313,0
1984,CA,37,153832,80012,0,233844,0
1984,CA,38,114786,48856,0,163642,0
1984,CA,39,185491,52591,0,238082,0
1984,CA,40,198338,63210,0,261548,0
1984,CA,41,171535,92994,0,264529,0
1984,CA,42,183392,67480,0,250872,0
1984,CA,43,176550,58918,0,235468,0
1984,CA,44,79269,71160,0,150429,0
1984,CA,45,149282,58141,0,207423,0
1984,CO,1,94321,104299,0,198620,0
1984,CO,2,128573,82590,0,211163,0
1984,CO,3,131951,76642,0,208593,0
1984,CO,4,139048,64939,0,203987,0
1984,CO,5,154780,50465,0,205245,0
1984,CO,6,148667,65629,0,214296,0
1984,CT,1,129384,115174,1060,245618,1060
1984,CT,2,141593,90869,1105,233567,1105
1984,CT,3,146171,101877,1078,249126,1078
1984,CT,4,154515,88941,1036,244492,1036
1984,CT,5,163371,80816,1146,245333,1146
1984,CT,6,155843,91920,1001,248764,1001
1984,DE,AL,152190,101656,726,254572,726
1984,DC,AL,29009,180408,1871,211288,1871
1984,FL,1,159173,50052,0,209225,0
1984,FL,2,126656,78549,0,205205,0
1984,FL,3,103133,71347,0,174480,0
1984,FL,4,151528,74921,0,226449,0
1984,FL,5,134122,53580,0,187702,0
1984,FL,6,154985,85603,0,240588,0
1984,FL,7,119135,70645,0,189780,0
1984,FL,8,153584,91393,0,244977,0
1984,FL,9,187534,90468,0,278002,0
1984,FL,10,150110,60788,0,210898,0
1984,FL,11,182952,63214,0,246166,0
1984,FL,12,158850,78830,0,237680,0
1984,FL,13,221828,77085,0,298913,0
1984,FL,14,171663,110775,0,282438,0
1984,FL,15,117110,81906,0,199016,0
1984,FL,16,123441,78576,0,202017,0
1984,FL,17,80780,93545,0,174325,0
1984,FL,18,91297,59926,0,151223,0
1984,FL,19,124180,68079,0,192259,0
1984,GA,1,100525,69408,0,169933,0
1984,GA,2,88306,62974,0,151280,0
1984,GA,3,83658,68149,0,151807,0
1984,GA,4,148469,77481,0,225950,0
1984,GA,5,60150,124006,0,184156,0
1984,GA,6,177764,53929,0,231693,0
1984,GA,7,144315,53882,0,198197,0
1984,GA,8,89777,81998,0,171775,0
1984,GA,9,119570,52894,0,172464,0
1984,GA,10,116188,61907,0,178095,0
1984,HI,1,93894,74912,1564,170370,1564
1984,HI,2,91156,72241,2078,165475,2078
1984,ID,1,140142,61983,0,202125,0
1984,ID,2,157381,46527,0,203908,0
1984,IL,1,10153,196351,0,206504,0
1984,IL,2,32693,168174,0,200867,0
1984,IL,3,158281,84752,0,243033,0
1984,IL,4,99161,98980,0,198141,0
1984,IL,5,107199,76570,0,183769,0
1984,IL,6,121280,96517,0,217797,0
1984,IL,7,47301,141185,0,188486,0
1984,IL,8,90875,85928,0,176803,0
1984,IL,9,106151,129644,0,235795,0
1984,IL,10,153888,70590,0,224478,0
1984,IL,11,149521,102584,0,252105,0
1984,IL,12,168010,50512,0,218522,0
1984,IL,13,133234,112891,0,246125,0
1984,IL,14,154144,68645,0,222789,0
1984,IL,15,140972,66325,0,207297,0
1984,IL,16,138250,80648,0,218898,0
1984,IL,17,123054,103528,0,226582,0
1984,IL,18,107217,66107,0,173324,0
1984,IL,19,141611,85323,0,226934,0
1984,IL,20,107579,77720,0,185299,0
1984,IL,21,114814,100098,0,214912,0
1984,IL,22,131531,104010,0,235541,0
1984,IN,1,94470,124834,0,219304,0
1984,IN,2,151940,71784,0,223724,0
1984,IN,3,136450,83076,0,219526,0
1984,IN,4,144009,70300,0,214309,0
1984,IN,5,150354,67224,0,217578,0
1984,IN,6,179556,69858,0,249414,0
1984,IN,7,147763,73751,0,221514,0
1984,IN,8,142987,92874,0,235861,0
1984,IN,9,134753,86932,0,221685,0
1984,IN,10,94948,100848,0,195796,0
1984,IA,1,110057,99112,1728,210897,1728
1984,IA,2,113814,100647,1990,216451,1990
1984,IA,3,118411,108563,1930,228904,1930
1984,IA,4,115898,118092,1646,235636,1646
1984,IA,5,122424,89132,1911,213467,1911
1984,IA,6,122484,90074,1892,214450,1892
1984,KS,1,158955,53970,2362,215287,2362
1984,KS,2,120455,67134,1507,189096,1507
1984,KS,3,138118,78289,1378,217785,1378
1984,KS,4,124731,70140,2322,197193,2322
1984,KS,5,135037,63616,1868,200521,1868
1984,KY,1,104613,87339,0,191952,0
1984,KY,2,112019,64163,0,176182,0
1984,KY,3,109042,99200,0,208242,0
1984,KY,4,143262,62253,0,205515,0
1984,KY,5,133941,58733,0,192674,0
1984,KY,6,123859,72942,0,196801,0
1984,KY,7,88609,92010,0,180619,0
1984,LA,1,164183,47092,0,211275,0
1984,LA,2,70452,116480,0,186932,0
1984,LA,3,139964,71187,0,211151,0
1984,LA,4,130580,67840,0,198420,0
1984,LA,5,140228,69083,0,209311,0
1984,LA,6,143578,78263,0,221841,0
1984,LA,7,133221,91268,0,224489,0
1984,LA,8,115095,110380,0,225475,0
1984,ME,1,175472,117450,1057,293979,1057
1984,ME,2,161028,97065,1072,259165,1072
1984,MD,1,121294,64381,696,186371,696
1984,MD,2,145320,74102,1103,220525,1103
1984,MD,3,110231,108399,1253,219883,1253
1984,MD,4,115669,79144,1085,195898,1085
1984,MD,5,79134,108074,860,188068,860
1984,MD,6,146543,66062,977,213582,977
1984,MD,7,32980,151669,1211,185860,1211
1984,MD,8,128747,136104,835,265686,835
1984,MA,1,116692,111393,970,229055,970
1984,MA,2,113384,98340,761,212485,761
1984,MA,3,131134,100152,718,232004,718
1984,MA,4,115692,123489,712,239893,712
1984,MA,5,130968,98649,828,230445,828
1984,MA,6,137258,110771,959,248988,959
1984,MA,7,123559,121018,743,245320,743
1984,MA,8,80756,142158,796,223710,796
1984,MA,9,104484,111765,825,217074,825
1984,MA,10,142887,116933,971,260791,971
1984,MA,11,114122,104938,628,219688,628
1984,MI,1,24697,151800,0,176497,0
1984,MI,2,142572,79004,0,221576,0
1984,MI,3,131761,75868,0,207629,0
1984,MI,4,140832,61564,0,202396,0
1984,MI,5,159335,73908,0,233243,0
1984,MI,6,119396,68578,0,187974,0
1984,MI,7,112880,94963,0,207843,0
1984,MI,8,122705,79934,0,202639,0
1984,MI,9,155242,69276,0,224518,0
1984,MI,10,145480,69170,0,214650,0
1984,MI,11,135537,93600,0,229137,0
1984,MI,12,121510,61591,0,183101,0
1984,MI,13,23926,136251,0,160177,0
1984,MI,14,156332,90562,0,246894,0
1984,MI,15,112238,71126,0,183364,0
1984,MI,16,125502,83958,0,209460,0
1984,MI,17,119118,101902,0,221020,0
1984,MI,18,202418,66683,0,269101,0
1984,MN,1,137333,109652,0,246985,0
1984,MN,2,139872,105227,0,245099,0
1984,MN,3,172921,120020,0,292941,0
1984,MN,4,107329,157060,0,264389,0
1984,MN,5,103103,168686,0,271789,0
1984,MN,6,135232,123181,0,258413,0
1984,MN,7,135320,102240,0,237560,0
1984,MN,8,101068,150038,0,251106,0
1984,MS,1,111501,66722,0,178223,0
1984,MS,2,86648,84965,0,171613,0
1984,MS,3,133167,70385,0,203552,0
1984,MS,4,122823,85513,0,208336,0
1984,MS,5,128188,45663,0,173851,0
1984,MO,1,76256,130288,0,206544,0
1984,MO,2,189802,96557,0,286359,0
1984,MO,3,158483,86792,0,245275,0
1984,MO,4,156449,76523,0,232972,0
1984,MO,5,106239,122535,0,228774,0
1984,MO,6,144857,94371,0,239228,0
1984,MO,7,164696,74275,0,238971,0
1984,MO,8,126547,82559,0,209106,0
1984,MO,9,150859,84683,0,235542,0
1984,MT,1,113967,78513,3037,195517,3037
1984,MT,2,118483,68229,2148,188860,2148
1984,NE,1,144198,69923,0,214121,0
1984,NE,2,144901,70238,0,215139,0
1984,NE,3,170955,47705,0,218660,0
1984,NV,1,82265,47156,0,129421,0
1984,NV,2,106505,44499,0,151004,0
1984,NH,1,137856,58851,750,197457,750
1984,NH,2,129195,61544,758,191497,758
1984,NJ,1,118015,96877,0,214892,0
1984,NJ,2,138241,84704,0,222945,0
1984,NJ,3,161447,79811,0,241258,0
1984,NJ,4,141308,98386,0,239694,0
1984,NJ,5,182030,75000,0,257030,0
1984,NJ,6,135654,94024,0,229678,0
1984,NJ,7,151973,88874,0,240847,0
1984,NJ,8,121422,89625,0,211047,0
1984,NJ,9,150514,103831,0,254345,0
1984,NJ,10,36554,110470,0,147024,0
1984,NJ,11,171632,78701,0,250333,0
1984,NJ,12,160027,84541,0,244568,0
1984,NJ,13,161435,86540,0,247975,0
1984,NJ,14,102475,89414,0,191889,0
1984,NM,1,108766,70395,1859,181020,1859
1984,NM,2,108723,53600,1705,164028,1705
1984,NM,3,89612,77774,1936,169322,1936
1984,NY,1,137855,70592,0,208447,0
1984,NY,2,123453,62326,0,185779,0
1984,NY,3,159039,87624,0,246663,0
1984,NY,4,155268,88668,0,243936,0
1984,NY,5,146746,95862,0,242608,0
1984,NY,6,54867,111850,0,166717,0
1984,NY,7,75972,87366,0,163338,0
1984,NY,8,92013,102439,0,194452,0
1984,NY,9,84812,64701,0,149513,0
1984,NY,10,90357,93499,0,183856,0
1984,NY,11,25558,94574,0,120132,0
1984,NY,12,15414,91344,0,106758,0
1984,NY,13,64033,71441,0,135474,0
1984,NY,14,118383,61868,0,180251,0
1984,NY,15,77670,118791,0,196461,0
1984,NY,16,23403,126326,0,149729,0
1984,NY,17,55449,164511,0,219960,0
1984,NY,18,22258,94844,0,117102,0
1984,NY,19,93925,85898,0,179823,0
1984,NY,20,129284,100394,0,229678,0
1984,NY,21,150345,70809,0,221154,0
1984,NY,22,141052,88027,0,229079,0
1984,NY,23,135744,120950,0,256694,0
1984,NY,24,162977,73186,0,236163,0
1984,NY,25,137582,81369,0,218951,0
1984,NY,26,135207,70730,0,205937,0
1984,NY,27,136687,88959,0,225646,0
1984,NY,28,140748,89680,0,230428,0
1984,NY,29,187701,118461,0,306162,0
1984,NY,30,146995,86565,0,233560,0
1984,NY,31,142852,88264,0,231116,0
1984,NY,32,119656,98874,0,218530,0
1984,NY,33,82638,138687,0,221325,0
1984,NY,34,142401,67870,0,210271,0
1984,NC,1,109441,82194,0,191635,0
1984,NC,2,103780,92146,0,195926,0
1984,NC,3,98076,63862,0,161938,0
1984,NC,4,137174,90622,0,227796,0
1984,NC,5,136330,76012,0,212342,0
1984,NC,6,129630,68726,0,198356,0
1984,NC,7,87143,65964,0,153107,0
1984,NC,8,128219,65912,0,194131,0
1984,NC,9,144258,79612,0,223870,0
1984,NC,10,136320,59796,0,196116,0
1984,NC,11,135124,79149,0,214273,0
1984,ND,AL,200336,104429,4206,308971,4206
1984,OH,1,144629,77558,0,222187,0
1984,OH,2,144299,78294,0,222593,0
1984,OH,3,113499,87666,0,201165,0
1984,OH,4,158640,54963,0,213603,0
1984,OH,5,145121,68285,0,213406,0
1984,OH,6,142779,65522,0,208301,0
1984,OH,7,135554,62431,0,197985,0
1984,OH,8,151663,55471,0,207134,0
1984,OH,9,110570,104597,0,215167,0
1984,OH,10,139324,68985,0,208309,0
1984,OH,11,124751,83671,0,208422,0
1984,OH,12,151294,76873,0,228167,0
1984,OH,13,121812,84648,0,206460,0
1984,OH,14,112676,107638,0,220314,0
1984,OH,15,150714,71086,0,221800,0
1984,OH,16,129748,79292,0,209040,0
1984,OH,17,95840,129930,0,225770,0
1984,OH,18,111625,96643,0,208268,0
1984,OH,19,152025,103904,0,255929,0
1984,OH,20,98665,103715,0,202380,0
1984,OH,21,43331,164178,0,207509,0
1984,OK,1,158304,65241,0,223545,0
1984,OK,2,139721,77923,0,217644,0
1984,OK,3,124798,75671,0,200469,0
1984,OK,4,131690,57118,0,188808,0
1984,OK,5,170703,50701,0,221404,0
1984,OK,6,136314,58246,0,194560,0
1984,OR,1,147889,112844,0,260733,0
1984,OR,2,155530,85806,0,241336,0
1984,OR,3,111509,127984,0,239493,0
1984,OR,4,126393,109603,0,235996,0
1984,OR,5,144219,100146,0,244365,0
1984,PA,1,75134,140556,0,215690,0
1984,PA,2,24593,211734,0,236327,0
1984,PA,3,136416,116335,0,252751,0
1984,PA,4,96942,104970,0,201912,0
1984,PA,5,134101,66408,0,200509,0
1984,PA,6,121264,68281,0,189545,0
1984,PA,7,155576,94017,0,249593,0
1984,PA,8,142572,79464,0,222036,0
1984,PA,9,118517,59149,0,177666,0
1984,PA,10,123789,76046,0,199835,0
1984,PA,11,107374,84245,0,191619,0
1984,PA,12,101621,98424,0,200045,0
1984,PA,13,146396,97418,0,243814,0
1984,PA,14,69649,157625,0,227274,0
1984,PA,15,110142,81072,0,191214,0
1984,PA,16,137697,47829,0,185526,0
1984,PA,17,123660,61213,0,184873,0
1984,PA,18,144507,103639,0,248146,0
1984,PA,19,131292,62016,0,193308,0
1984,PA,20,83901,137742,0,221643,0
1984,PA,21,105513,92940,0,198453,0
1984,PA,22,77235,102681,0,179916,0
1984,PA,23,116398,68729,0,185127,0
1984,RI,1,101628,99060,0,200688,0
1984,RI,2,110452,98046,0,208498,0
1984,SC,1,106107,58243,0,164350,0
1984,SC,2,105337,61368,0,166705,0
1984,SC,3,102301,49116,0,151417,0
1984,SC,4,114650,48691,0,163341,0
1984,SC,5,94269,58350,0,152619,0
1984,SC,6,92875,68691,0,161566,0
1984,SD,AL,200267,116113,1487,317867,1487
1984,TN,1,129514,51916,1258,182688,1258
1984,TN,2,123657,67339,975,191971,975
1984,TN,3,121921,72122,1017,195060,1017
1984,TN,4,95172,69685,1114,165971,1114
1984,TN,5,103600,95254,1223,200077,1223
1984,TN,6,108626,75667,1289,185582,1289
1984,TN,7,130862,67173,1091,199126,1091
1984,TN,8,98966,74732,877,174575,877
1984,TN,9,77894,137826,1224,216944,1224
1984,TX,1,126587,79104,0,205691,0
1984,TX,2,115240,81216,0,196456,0
1984,TX,3,235644,52426,0,288070,0
1984,TX,4,150182,66550,0,216732,0
1984,TX,5,100261,68926,0,169187,0
1984,TX,6,166428,72109,0,238537,0
1984,TX,7,207297,42452,0,249749,0
1984,TX,8,109321,71779,0,181100,0
1984,TX,9,110918,99905,0,210823,0
1984,TX,10,154846,111902,0,266748,0
1984,TX,11,118091,60086,0,178177,0
1984,TX,12,113047,80077,0,193124,0
1984,TX,13,145536,56686,0,202222,0
1984,TX,14,139706,67157,0,206863,0
1984,TX,15,77846,90082,0,167928,0
1984,TX,16,75896,57337,0,133233,0
1984,TX,17,141365,65558,0,206923,0
1984,TX,18,39242,103082,0,142324,0
1984,TX,19,133422,44562,0,177984,0
1984,TX,20,58751,83214,0,141965,0
1984,TX,21,200152,56786,0,256938,0
1984,TX,22,138662,58984,0,197646,0
1984,TX,23,95995,66186,0,162181,0
1984,TX,24,96596,85078,0,181674,0
1984,TX,25,97381,86808,0,184189,0
1984,TX,26,194141,59341,0,253482,0
1984,TX,27,91382,80883,0,172265,0
1984,UT,1,170555,47364,0,217919,0
1984,UT,2,144966,64712,0,209678,0
1984,UT,3,153584,43293,0,196877,0
1984,VT,AL,135865,95730,2966,234561,2966
1984,VA,1,132393,79051,1569,213013,1569
1984,VA,2,108931,63616,563,173110,563
1984,VA,3,155612,83310,877,239799,877
1984,VA,4,117579,91107,1835,210521,1835
1984,VA,5,131912,67480,2143,201535,2143
1984,VA,6,134466,68311,1280,204057,1280
1984,VA,7,142598,64593,1109,208300,1109
1984,VA,8,141992,89349,1103,232444,1103
1984,VA,9,117088,82522,1848,201458,1848
1984,VA,10,154507,106911,980,262398,980
1984,WA,1,151870,112927,0,264797,0
1984,WA,2,134985,107697,0,242682,0
1984,WA,3,117626,99899,0,217525,0
1984,WA,4,134406,74346,0,208752,0
1984,WA,5,134923,86838,0,221761,0
1984,WA,6,116652,85889,0,202541,0
1984,WA,7,104330,146221,0,250551,0
1984,WA,8,156878,93535,0,250413,0
1984,WV,1,111290,84836,424,196550,424
1984,WV,2,107719,77702,320,185741,320
1984,WV,3,107004,84527,382,191913,382
1984,WV,4,79470,81060,363,160893,363
1984,WI,1,143113,114913,0,258026,0
1984,WI,2,124588,128947,0,253535,0
1984,WI,3,135466,108959,0,244425,0
1984,WI,4,109792,118528,0,228320,0
1984,WI,5,95590,146370,0,241960,0
1984,WI,6,146218,88041,0,234259,0
1984,WI,7,126988,114633,0,241621,0
1984,WI,8,154397,88909,0,243306,0
1984,WI,9,162433,86439,0,248872,0
1984,WY,AL,133241,53370,2357,188968,2357
1988,AL,1,121510,73312,0,194822,0
1988,AL,2,118794,71335,0,190129,0
1988,AL,3,106069,67936,0,174005,0
1988,AL,4,111590,83061,0,194651,0
1988,AL,5,111763,77172,0,188935,0
1988,AL,6,121126,90465,0,211591,0
1988,AL,7,124724,86225,0,210949,0
1988,AK,AL,119251,72584,8281,200116,8281
1988,AZ,1,171884,90383,0,262267,0
1988,AZ,2,60606,77493,0,138099,0
1988,AZ,3,165706,89460,0,255166,0
1988,AZ,4,167264,88773,0,256037,0
1988,AZ,5,137081,107920,0,245001,0
1988,AR,1,95388,89812,2246,187446,2246
1988,AR,2,121130,91705,2584,215419,2584
1988,AR,3,146498,74413,2377,223288,2377
1988,AR,4,103562,93307,3397,200266,3397
1988,CA,1,114103,145811,0,259914,0
1988,CA,2,138756,96230,0,234986,0
1988,CA,3,132533,130495,0,263028,0
1988,CA,4,129477,121847,0,251324,0
1988,CA,5,57846,148818,0,206664,0
1988,CA,6,89300,164296,0,253596,0
1988,CA,7,116314,136163,0,252477,0
1988,CA,8,74533,178961,0,253494,0
1988,CA,9,91636,124397,0,216033,0
1988,CA,10,80564,101751,0,182315,0
1988,CA,11,89063,126351,0,215414,0
1988,CA,12,133699,132918,0,266617,0
1988,CA,13,108817,109830,0,218647,0
1988,CA,14,165850,111570,0,277420,0
1988,CA,15,92471,82819,0,175290,0
1988,CA,16,100293,122419,0,222712,0
1988,CA,17,111250,76021,0,187271,0
1988,CA,18,88016,101146,0,189162,0
1988,CA,19,123145,101934,0,225079,0
1988,CA,20,150366,79866,0,230232,0
1988,CA,21,178542,95910,0,274452,0
1988,CA,22,158823,86732,0,245555,0
1988,CA,23,106610,138264,0,244874,0
1988,CA,24,55756,106652,0,162408,0
1988,CA,25,34925,74007,0,108932,0
1988,CA,26,85640,108660,0,194300,0
1988,CA,27,102897,126695,0,229592,0
1988,CA,28,40680,113133,0,153813,0
1988,CA,29,22052,92086,0,114138,0
1988,CA,30,57754,66112,0,123866,0
1988,CA,31,51505,96554,0,148059,0
1988,CA,32,89411,87998,0,177409,0
1988,CA,33,142335,83319,0,225654,0
1988,CA,34,73409,76154,0,149563,0
1988,CA,35,172872,88126,0,260998,0
1988,CA,36,100291,92521,0,192812,0
1988,CA,37,172644,108106,0,280750,0
1988,CA,38,93697,58068,0,151765,0
1988,CA,39,167142,66495,0,233637,0
1988,CA,40,191392,87331,0,278723,0
1988,CA,41,175588,121278,0,296866,0
1988,CA,42,165572,86544,0,252116,0
1988,CA,43,199744,90746,0,290490,0
1988,CA,44,74236,80893,0,155129,0
1988,CA,45,153368,76206,0,229574,0
1988,CO,1,73759,124474,0,198233,0
1988,CO,2,114652,120330,0,234982,0
1988,CO,3,114163,101540,0,215703,0
1988,CO,4,120611,95642,0,216253,0
1988,CO,5,169819,79437,0,249256,0
1988,CO,6,135173,100030,0,235203,0
1988,CT,1,106890,133867,2319,243076,2319
1988,CT,2,119947,115813,2819,238579,2819
1988,CT,3,119329,117432,3112,239873,3112
1988,CT,4,128702,96177,2608,227487,2608
1988,CT,5,141664,97553,3081,242298,3081
1988,CT,6,133709,115742,2623,252074,2623
1988,DE,AL,139639,108647,1605,249891,1605
1988,DC,AL,27590,159407,5880,192877,5880
1988,FL,1,161314,59014,0,220328,0
1988,FL,2,123524,83458,0,206982,0
1988,FL,3,97659,65215,0,162874,0
1988,FL,4,169949,95362,0,265311,0
1988,FL,5,131585,59038,0,190623,0
1988,FL,6,159938,101833,0,261771,0
1988,FL,7,107474,76831,0,184305,0
1988,FL,8,131100,103040,0,234140,0
1988,FL,9,178253,116408,0,294661,0
1988,FL,10,138108,69786,0,207894,0
1988,FL,11,191722,78493,0,270215,0
1988,FL,12,168433,92448,0,260881,0
1988,FL,13,225798,106428,0,332226,0
1988,FL,14,167352,147665,0,315017,0
1988,FL,15,102768,90113,0,192881,0
1988,FL,16,121521,97110,0,218631,0
1988,FL,17,58053,84029,0,142082,0
1988,FL,18,72421,52368,0,124789,0
1988,FL,19,111913,78062,0,189975,0
1988,GA,1,94646,62529,0,157175,0
1988,GA,2,83163,57423,0,140586,0
1988,GA,3,84006,62028,0,146034,0
1988,GA,4,142998,99212,0,242210,0
1988,GA,5,52118,113308,0,165426,0
1988,GA,6,121128,59118,0,180246,0
1988,GA,7,155367,64396,0,219763,0
1988,GA,8,85540,73518,0,159058,0
1988,GA,9,139037,56681,0,195718,0
1988,GA,10,123328,66579,0,189907,0
1988,HI,1,79323,95347,1447,176117,1447
1988,HI,2,79302,97017,2025,178344,2025
1988,ID,1,121392,80381,0,201773,0
1988,ID,2,132489,66891,0,199380,0
1988,IL,1,7168,174793,0,181961,0
1988,IL,2,25896,150387,0,176283,0
1988,IL,3,130606,92108,0,222714,0
1988,IL,4,103720,82662,0,186382,0
1988,IL,5,83892,77783,0,161675,0
1988,IL,6,147384,67355,0,214739,0
1988,IL,7,38432,132656,0,171088,0
1988,IL,8,63885,92135,0,156020,0
1988,IL,9,85855,137259,0,223114,0
1988,IL,10,143022,86280,0,229302,0
1988,IL,11,117883,101346,0,219229,0
1988,IL,12,161448,66474,0,227922,0
1988,IL,13,179219,81899,0,261118,0
1988,IL,14,144972,81320,0,226292,0
1988,IL,15,124915,74312,0,199227,0
1988,IL,16,116627,85552,0,202179,0
1988,IL,17,95672,107639,0,203311,0
1988,IL,18,114566,94582,0,209148,0
1988,IL,19,114219,95602,0,209821,0
1988,IL,20,113676,110072,0,223748,0
1988,IL,21,92957,110653,0,203610,0
1988,IL,22,104885,113071,0,217956,0
1988,IN,1,78515,112270,0,190785,0
1988,IN,2,144206,76764,0,220970,0
1988,IN,3,128039,87080,0,215119,0
1988,IN,4,143461,71156,0,214617,0
1988,IN,5,136223,73065,0,209288,0
1988,IN,6,188615,82201,0,270816,0
1988,IN,7,136233,79244,0,215477,0
1988,IN,8,133017,97530,0,230547,0
1988,IN,9,123198,89744,0,212942,0
1988,IN,10,86331,91726,0,178057,0
1988,IA,1,86724,106756,1775,195255,1775
1988,IA,2,86874,113993,1574,202441,1574
1988,IA,3,89365,118602,1778,209745,1778
1988,IA,4,90855,131356,1370,223581,1370
1988,IA,5,92323,100734,1671,194728,1671
1988,IA,6,99214,99116,1534,199864,1534
1988,KS,1,120325,74716,3904,198945,3904
1988,KS,2,99411,85689,2303,187403,2303
1988,KS,3,121658,99785,2152,223595,2152
1988,KS,4,108417,84235,5111,197763,5111
1988,KS,5,104238,78211,2889,185338,2889
1988,KY,1,96150,92391,0,188541,0
1988,KY,2,102721,72768,0,175489,0
1988,KY,3,88129,101458,0,189587,0
1988,KY,4,135832,72430,0,208262,0
1988,KY,5,120671,59945,0,180616,0
1988,KY,6,112162,82755,0,194917,0
1988,KY,7,78616,98621,0,177237,0
1988,LA,1,149519,61214,0,210733,0
1988,LA,2,51739,112977,0,164716,0
1988,LA,3,114277,90809,0,205086,0
1988,LA,4,112042,77197,0,189239,0
1988,LA,5,122014,70397,0,192411,0
1988,LA,6,128304,83704,0,212008,0
1988,LA,7,106573,105908,0,212481,0
1988,LA,8,99234,115224,0,214458,0
1988,ME,1,169292,131078,2392,302762,2392
1988,ME,2,137839,112491,1943,252273,1943
1988,MD,1,131161,75575,935,207671,935
1988,MD,2,141948,85451,1342,228741,1342
1988,MD,3,95071,113869,1380,210320,1380
1988,MD,4,120027,87650,1738,209415,1738
1988,MD,5,72873,107195,1967,182035,1967
1988,MD,6,158808,82781,1199,242788,1199
1988,MD,7,26360,123261,1934,151555,1934
1988,MD,8,129919,150522,1392,281833,1392
1988,MA,1,96021,134243,2168,232432,2168
1988,MA,2,102349,113877,1980,218206,1980
1988,MA,3,123471,120907,3113,247491,3113
1988,MA,4,104853,141008,2780,248641,2780
1988,MA,5,120945,112301,3900,237146,3900
1988,MA,6,125871,131246,4350,261467,4350
1988,MA,7,114124,133241,4000,251365,4000
1988,MA,8,70811,141368,3622,215801,3622
1988,MA,9,96849,115812,3549,216210,3549
1988,MA,10,136345,143938,3936,284219,3936
1988,MA,11,104005,113465,3353,220823,3353
1988,MI,1,15099,126551,0,141650,0
1988,MI,2,130585,94358,0,224943,0
1988,MI,3,108143,91318,0,199461,0
1988,MI,4,124506,71397,0,195903,0
1988,MI,5,151994,83993,0,235987,0
1988,MI,6,120819,89071,0,209890,0
1988,MI,7,89235,112101,0,201336,0
1988,MI,8,101657,101061,0,202718,0
1988,MI,9,143764,85457,0,229221,0
1988,MI,10,126899,90335,0,217234,0
1988,MI,11,117173,105030,0,222203,0
1988,MI,12,126846,82413,0,209259,0
1988,MI,13,16127,100969,0,117096,0
1988,MI,14,107535,84746,0,192281,0
1988,MI,15,95010,79994,0,175004,0
1988,MI,16,106007,91270,0,197277,0
1988,MI,17,92015,105431,0,197446,0
1988,MI,18,192072,80288,0,272360,0
1988,MN,1,112629,116414,0,229043,0
1988,MN,2,118769,112838,0,231607,0
1988,MN,3,182877,150082,0,332959,0
1988,MN,4,99961,160154,0,260115,0
1988,MN,5,85100,166580,0,251680,0
1988,MN,6,140362,148030,0,288392,0
1988,MN,7,119691,110605,0,230296,0
1988,MN,8,92948,144768,0,237716,0
1988,MS,1,109304,73839,0,183143,0
1988,MS,2,82403,87386,0,169789,0
1988,MS,3,124841,64007,0,188848,0
1988,MS,4,114110,85094,0,199204,0
1988,MS,5,126860,53595,0,180455,0
1988,MO,1,54578,143802,0,198380,0
1988,MO,2,173205,111172,0,284377,0
1988,MO,3,126310,111956,0,238266,0
1988,MO,4,139370,95117,0,234487,0
1988,MO,5,83926,129433,0,213359,0
1988,MO,6,115674,115469,0,231143,0
1988,MO,7,148460,92866,0,241326,0
1988,MO,8,111605,91370,0,202975,0
1988,MO,9,131825,110434,0,242259,0
1988,MT,1,95054,91519,3603,190176,3603
1988,MT,2,95358,77437,2723,175518,2723
1988,NE,1,123674,96134,0,219808,0
1988,NE,2,130193,94071,0,224264,0
1988,NE,3,144089,69030,0,213119,0
1988,NV,1,90541,67519,4491,162551,4491
1988,NV,2,115499,65219,6798,187516,6798
1988,NH,1,145996,80604,2980,229580,2980
1988,NH,2,135541,83092,2312,220945,2312
1988,NJ,1,107784,97658,0,205442,0
1988,NJ,2,127331,89369,0,216700,0
1988,NJ,3,151582,91100,0,242682,0
1988,NJ,4,139824,110623,0,250447,0
1988,NJ,5,164951,82324,0,247275,0
1988,NJ,6,115133,101046,0,216179,0
1988,NJ,7,132400,90800,0,223200,0
1988,NJ,8,102412,85605,0,188017,0
1988,NJ,9,122284,105839,0,228123,0
1988,NJ,10,24123,90963,7362,122448,7362
1988,NJ,11,156769,85011,0,241780,0
1988,NJ,12,162819,98355,0,261174,0
1988,NJ,13,159742,98736,0,258478,0
1988,NJ,14,76021,93287,0,169308,0
1988,NM,1,96586,81687,0,178273,0
1988,NM,2,96142,67307,0,163449,0
1988,NM,3,77613,95503,0,173116,0
1988,NY,1,131180,85652,0,216832,0
1988,NY,2,112570,70748,0,183318,0
1988,NY,3,141465,94781,0,236246,0
1988,NY,4,134515,94111,0,228626,0
1988,NY,5,124622,97312,0,221934,0
1988,NY,6,39327,103007,0,142334,0
1988,NY,7,57353,87214,0,144567,0
1988,NY,8,69870,101681,0,171551,0
1988,NY,9,66627,70331,0,136958,0
1988,NY,10,68898,89508,0,158406,0
1988,NY,11,15298,80095,0,95393,0
1988,NY,12,10748,101326,0,112074,0
1988,NY,13,56129,73438,0,129567,0
1988,NY,14,105315,67361,0,172676,0
1988,NY,15,65134,131052,0,196186,0
1988,NY,16,14960,114237,0,129197,0
1988,NY,17,44801,169463,0,214264,0
1988,NY,18,13055,91928,0,104983,0
1988,NY,19,72262,85832,0,158094,0
1988,NY,20,112224,104728,0,216952,0
1988,NY,21,135851,83633,0,219484,0
1988,NY,22,129459,97516,0,226975,0
1988,NY,23,106755,140440,0,247195,0
1988,NY,24,142169,98965,0,241134,0
1988,NY,25,114277,94653,0,208930,0
1988,NY,26,109749,87213,0,196962,0
1988,NY,27,116123,103274,0,219397,0
1988,NY,28,118542,108155,0,226697,0
1988,NY,29,113994,99637,0,213631,0
1988,NY,30,127474,106375,0,233849,0
1988,NY,31,130130,101868,0,231998,0
1988,NY,32,98419,104508,0,202927,0
1988,NY,33,65216,130129,0,195345,0
1988,NY,34,118065,78927,0,196992,0
1988,NC,1,97424,83301,0,180725,0
1988,NC,2,92768,93736,0,186504,0
1988,NC,3,85776,62862,0,148638,0
1988,NC,4,132495,105357,0,237852,0
1988,NC,5,123725,81340,0,205065,0
1988,NC,6,118565,76208,0,194773,0
1988,NC,7,77438,73231,0,150669,0
1988,NC,8,119272,73450,0,192722,0
1988,NC,9,140777,89322,0,230099,0
1988,NC,10,120503,63589,0,184092,0
1988,NC,11,128515,87771,0,216286,0
1988,ND,AL,166559,127739,2963,297261,2963
1988,OH,1,131747,76661,0,208408,0
1988,OH,2,138698,83366,0,222064,0
1988,OH,3,106157,87465,0,193622,0
1988,OH,4,140598,65901,0,206499,0
1988,OH,5,128479,79946,0,208425,0
1988,OH,6,136915,74200,0,211115,0
1988,OH,7,126434,69649,0,196083,0
1988,OH,8,147196,65826,0,213022,0
1988,OH,9,92563,107960,0,200523,0
1988,OH,10,125699,79608,0,205307,0
1988,OH,11,116101,93849,0,209950,0
1988,OH,12,138992,86297,0,225289,0
1988,OH,13,109471,93497,0,202968,0
1988,OH,14,98111,110222,0,208333,0
1988,OH,15,137729,81708,0,219437,0
1988,OH,16,116353,86957,0,203310,0
1988,OH,17,79756,130383,0,210139,0
1988,OH,18,93959,102998,0,196957,0
1988,OH,19,140174,115180,0,255354,0
1988,OH,20,77551,103933,0,181484,0
1988,OH,21,33866,144023,0,177889,0
1988,OK,1,120873,76349,0,197222,0
1988,OK,2,110246,97194,0,207440,0
1988,OK,3,95225,94615,0,189840,0
1988,OK,4,105170,74429,0,179599,0
1988,OK,5,145247,68735,0,213982,0
1988,OK,6,101606,72101,0,173707,0
1988,OR,1,126763,137972,0,264735,0
1988,OR,2,122981,98308,0,221289,0
1988,OR,3,89744,143542,0,233286,0
1988,OR,4,99085,120036,0,219121,0
1988,OR,5,121553,116348,0,237901,0
1988,PA,1,60033,121095,0,181128,0
1988,PA,2,17151,187254,0,204405,0
1988,PA,3,115312,110228,0,225540,0
1988,PA,4,81028,97784,0,178812,0
1988,PA,5,133148,70808,0,203956,0
1988,PA,6,112048,70915,0,182963,0
1988,PA,7,140716,93286,0,234002,0
1988,PA,8,138869,88081,0,226950,0
1988,PA,9,106383,61408,0,167791,0
1988,PA,10,112038,80528,0,192566,0
1988,PA,11,94061,84893,0,178954,0
1988,PA,12,86183,96166,0,182349,0
1988,PA,13,135283,104266,0,239549,0
1988,PA,14,51387,140594,0,191981,0
1988,PA,15,103803,84625,0,188428,0
1988,PA,16,132402,84625,0,217027,0
1988,PA,17,112911,64505,0,177416,0
1988,PA,18,123583,106535,0,230118,0
1988,PA,19,125523,65656,0,191179,0
1988,PA,20,67172,125909,0,193081,0
1988,PA,21,91555,94351,0,185906,0
1988,PA,22,61947,115106,0,177053,0
1988,PA,23,97551,73737,0,171288,0
1988,RI,1,83140,112949,0,196089,0
1988,RI,2,94621,112174,0,206795,0
1988,SC,1,100179,62594,0,162773,0
1988,SC,2,103577,67446,0,171023,0
1988,SC,3,108043,54507,0,162550,0
1988,SC,4,114191,54572,0,168763,0
1988,SC,5,91385,61398,0,152783,0
1988,SC,6,89068,70037,0,159105,0
1988,SD,AL,165415,145560,2016,312991,2016
1988,TN,1,117511,54455,0,171966,0
1988,TN,2,117355,65552,0,182907,0
1988,TN,3,117220,70874,0,188094,0
1988,TN,4,91186,66656,0,157842,0
1988,TN,5,104313,95154,0,199467,0
1988,TN,6,111548,72992,0,184540,0
1988,TN,7,138246,67200,0,205446,0
1988,TN,8,89899,69420,0,159319,0
1988,TN,9,59955,117491,0,177446,0
1988,TX,1,107949,97014,0,204963,0
1988,TX,2,98720,99074,0,197794,0
1988,TX,3,215204,72929,0,288133,0
1988,TX,4,131134,83578,0,214712,0
1988,TX,5,80275,80731,0,161006,0
1988,TX,6,158954,95403,0,254357,0
1988,TX,7,194529,56781,0,251310,0
1988,TX,8,89941,74588,0,164529,0
1988,TX,9,94083,105562,0,199645,0
1988,TX,10,132984,156015,0,288999,0
1988,TX,11,106061,75985,0,182046,0
1988,TX,12,98449,87316,0,185765,0
1988,TX,13,121111,68739,0,189850,0
1988,TX,14,121903,90108,0,212011,0
1988,TX,15,64034,108744,0,172778,0
1988,TX,16,63062,69550,0,132612,0
1988,TX,17,118173,85322,0,203495,0
1988,TX,18,30408,92191,0,122599,0
1988,TX,19,110148,54551,0,164699,0
1988,TX,20,44444,92584,0,137028,0
1988,TX,21,192335,78961,0,271296,0
1988,TX,22,120066,70739,0,190805,0
1988,TX,23,94826,93074,0,187900,0
1988,TX,24,87616,97357,0,184973,0
1988,TX,25,80566,84886,0,165452,0
1988,TX,26,203541,92508,0,296049,0
1988,TX,27,76313,88458,0,164771,0
1988,UT,1,162713,60984,0,223697,0
1988,UT,2,125619,86241,0,211860,0
1988,UT,3,140110,60118,0,200228,0
1988,VT,AL,124331,115775,3227,243333,3227
1988,VA,1,131341,83921,2725,217987,2725
1988,VA,2,107019,71558,1332,179909,1332
1988,VA,3,151033,86678,2122,239833,2122
1988,VA,4,110155,89094,1908,201157,1908
1988,VA,5,119560,71107,3023,193690,3023
1988,VA,6,121107,74602,2158,197867,2158
1988,VA,7,149725,76202,2401,228328,2401
1988,VA,8,157228,102516,1961,261705,1961
1988,VA,9,98783,82873,2617,184273,2617
1988,VA,10,163211,121878,2401,287490,2401
1988,WA,1,139138,141024,0,280162,0
1988,WA,2,119362,120954,0,240316,0
1988,WA,3,104641,113785,0,218426,0
1988,WA,4,109085,78786,0,187871,0
1988,WA,5,105193,99301,0,204494,0
1988,WA,6,97396,101782,0,199178,0
1988,WA,7,78238,162541,0,240779,0
1988,WA,8,150782,115343,0,266125,0
1988,WV,1,84142,89128,686,173956,686
1988,WV,2,86633,81178,569,168380,569
1988,WV,3,81235,90179,556,171970,556
1988,WV,4,58055,80531,419,139005,419
1988,WI,1,107375,114078,0,221453,0
1988,WI,2,114114,145141,0,259255,0
1988,WI,3,112830,126354,0,239184,0
1988,WI,4,108994,140826,0,249820,0
1988,WI,5,80649,145028,0,225677,0
1988,WI,6,127820,106953,0,234773,0
1988,WI,7,108341,128849,0,237190,0
1988,WI,8,132358,117238,0,249596,0
1988,WI,9,155018,102327,0,257345,0
1988,WY,AL,106867,67113,2571,176551,2571
1992,AL,1,118420,84193,26749,229362,26749
1992,AL,2,123856,82656,27319,233831,27319
1992,AL,3,104928,91983,23733,220644,23733
1992,AL,4,107064,104526,28558,240148,28558
1992,AL,5,110268,102130,36921,249319,36921
1992,AL,6,183127,73463,28196,284786,28196
1992,AL,7,56620,151129,11633,219382,11633
1992,AK,AL,102000,78294,78212,258506,78212
1992,AZ,1,105784,88247,68143,262174,68143
1992,AZ,2,41757,74588,28767,145112,28767
1992,AZ,3,109840,86060,73356,269256,73356
1992,AZ,4,118927,86922,70682,276531,70682
1992,AZ,5,104509,116226,56516,277251,56516
1992,AZ,6,91269,91007,56277,238553,56277
1992,AR,1,71160,131585,21491,224236,21491
1992,AR,2,84922,130435,20788,236145,20788
1992,AR,3,107351,109111,37503,253965,37503
1992,AR,4,73891,134692,25969,234552,25969
1992,CA,1,71512,116029,62040,249581,62040
1992,CA,2,101505,93823,69456,264784,69456
1992,CA,3,89288,98333,54546,242167,54546
1992,CA,4,117155,97501,75079,289735,75079
1992,CA,5,73562,120577,44726,238865,44726
1992,CA,6,71564,169301,63590,304455,63590
1992,CA,7,48474,135098,39108,222680,39108
1992,CA,8,39396,187201,23181,249778,23181
1992,CA,9,29394,186714,23980,240088,23980
1992,CA,10,107191,127450,68006,302647,68006
1992,CA,11,75319,79432,42375,197126,42375
1992,CA,12,64967,139244,39564,243775,39564
1992,CA,13,55100,116829,44684,216613,44684
1992,CA,14,71736,143727,55594,271057,55594
1992,CA,15,83301,127060,66900,277261,66900
1992,CA,16,44693,86418,35524,166635,35524
1992,CA,17,57990,111937,44136,214063,44136
1992,CA,18,67898,74357,40590,182845,40590
1992,CA,19,97124,85049,42250,224423,42250
1992,CA,20,44674,55942,19037,119653,19037
1992,CA,21,94727,66284,44072,205083,44072
1992,CA,22,92045,106815,62780,261640,62780
1992,CA,23,74106,82613,59456,216175,59456
1992,CA,24,79728,128572,59285,267585,59285
1992,CA,25,89987,83305,58657,231949,58657
1992,CA,26,31013,72673,25075,128761,25075
1992,CA,27,80986,98057,43708,222751,43708
1992,CA,28,90644,82958,47010,220612,47010
1992,CA,29,55924,183233,39017,278174,39017
1992,CA,30,21750,56378,12676,90804,12676
1992,CA,31,37250,59616,19017,115883,19017
1992,CA,32,23956,147623,18976,190555,18976
1992,CA,33,12607,33642,7578,53827,7578
1992,CA,34,48181,78889,28799,155869,28799
1992,CA,35,16685,100432,12642,129759,12642
1992,CA,36,95646,111014,64447,271107,64447
1992,CA,37,19299,90523,13670,123492,13670
1992,CA,38,66647,88728,44996,200371,44996
1992,CA,39,100669,78305,52172,231146,52172
1992,CA,40,86453,76363,56292,219108,56292
1992,CA,41,78902,64666,42262,185830,42262
1992,CA,42,54978,76964,37372,169314,37372
1992,CA,43,76837,76040,49324,202201,49324
1992,CA,44,76772,87180,51809,215761,51809
1992,CA,45,105893,80646,65443,251982,65443
1992,CA,46,47689,44352,28438,120479,28438
1992,CA,47,127700,86279,66060,280039,66060
1992,CA,48,108581,71621,67479,247681,67479
1992,CA,49,82834,114081,68026,264941,68026
1992,CA,50,42830,69546,31282,143658,31282
1992,CA,51,108470,86870,75333,270673,75333
1992,CA,52,81421,74913,64775,221109,64775
1992,CO,1,63283,135016,43245,241544,43245
1992,CO,2,83209,123144,66678,273031,66678
1992,CO,3,92292,107227,67210,266729,67210
1992,CO,4,96638,94234,63203,254075,63203
1992,CO,5,125749,71185,57488,254422,57488
1992,CO,6,101679,98875,68186,268740,68186
1992,CT,1,82086,133686,53330,269102,53330
1992,CT,2,79110,113553,74049,266712,74049
1992,CT,3,96085,121163,55314,272562,55314
1992,CT,4,110072,109122,41828,261022,41828
1992,CT,5,111327,93966,62022,267315,62022
1992,CT,6,99633,110828,69158,279619,69158
1992,DE,AL,102313,126054,61368,289735,61368
1992,DC,AL,20698,192619,14255,227572,14255
1992,FL,1,117809,59316,53250,230375,53250
1992,FL,2,92805,100723,46958,240486,46958
1992,FL,3,49198,93446,21225,163869,21225
1992,FL,4,132023,75035,41075,248133,41075
1992,FL,5,90656,110244,64106,265006,64106
1992,FL,6,112554,74328,50914,237796,50914
1992,FL,7,105519,81180,49588,236287,49588
1992,FL,8,101707,68840,42901,213448,42901
1992,FL,9,113853,94662,68167,276682,68167
1992,FL,10,96956,107121,63765,267842,63765
1992,FL,11,77942,81849,39148,198939,39148
1992,FL,12,90694,68487,39770,198951,39770
1992,FL,13,124394,100831,65283,290508,65283
1992,FL,14,129493,87978,63175,280646,63175
1992,FL,15,117206,83507,69605,270318,69605
1992,FL,16,108503,98154,68543,275200,68543
1992,FL,17,25873,99422,9913,135208,9913
1992,FL,18,93870,54113,16988,164971,16988
1992,FL,19,89698,159284,46946,295928,46946
1992,FL,20,83485,116568,48687,248740,48687
1992,FL,21,85292,45778,15545,146615,15545
1992,FL,22,96986,115912,44845,257743,44845
1992,FL,23,35265,94873,22084,152222,22084
1992,GA,1,88703,71770,28292,188765,28292
1992,GA,2,47692,96684,17248,161624,17248
1992,GA,3,105731,80628,32285,218644,32285
1992,GA,4,116418,101990,33226,251634,33226
1992,GA,5,52191,140175,15241,207607,15241
1992,GA,6,155739,82381,41874,279994,41874
1992,GA,7,93175,77103,30097,200375,30097
1992,GA,8,93643,83976,32068,209687,32068
1992,GA,9,98205,70943,32808,201956,32808
1992,GA,10,99336,81960,30662,211958,30662
1992,GA,11,44419,121356,15676,181451,15676
1992,HI,1,72182,87664,24897,184743,24897
1992,HI,2,64640,91646,31813,188099,31813
1992,ID,1,101787,75499,70813,248099,70813
1992,ID,2,100858,61514,71643,234015,71643
1992,IL,1,32803,214104,17355,264262,17355
1992,IL,2,31634,194639,16950,243223,16950
1992,IL,3,102632,108342,52905,263879,52905
1992,IL,4,29093,82271,15272,126636,15272
1992,IL,5,80036,124273,39113,243422,39113
1992,IL,6,121868,86448,52734,261050,52734
1992,IL,7,35530,184966,15992,236488,15992
1992,IL,8,118714,76327,54269,249310,54269
1992,IL,9,68418,155446,29294,253158,29294
1992,IL,10,108149,112401,40719,261269,40719
1992,IL,11,90058,108456,50186,248700,50186
1992,IL,12,69829,132570,42169,244568,42169
1992,IL,13,128612,88314,58123,275049,58123
1992,IL,14,105700,83109,52914,241723,52914
1992,IL,15,98378,107914,47280,253572,47280
1992,IL,16,108949,95103,56169,260221,56169
1992,IL,17,95554,124175,45566,265295,45566
1992,IL,18,114090,117483,47087,278660,47087
1992,IL,19,95759,131396,50706,277861,50706
1992,IL,20,94038,129865,55712,279615,55712
1992,IN,1,68392,117115,37129,222636,37129
1992,IN,2,101370,82008,50458,233836,50458
1992,IN,3,91708,82483,41358,215549,41358
1992,IN,4,102779,69292,49565,221636,49565
1992,IN,5,103124,70891,52354,226369,52354
1992,IN,6,153269,61030,54909,269208,54909
1992,IN,7,103801,71273,48916,223990,48916
1992,IN,8,97062,103844,43177,244083,43177
1992,IN,9,97412,97970,44839,240221,44839
1992,IN,10,70458,92514,33229,196201,33229
1992,IA,1,95660,128655,54486,278801,54486
1992,IA,2,95005,120228,56932,272165,56932
1992,IA,3,96515,120495,50174,267184,50174
1992,IA,4,107745,117863,49122,274730,49122
1992,IA,5,109966,99112,51500,260578,51500
1992,KS,1,122817,81400,86379,290596,86379
1992,KS,2,98999,98527,76499,274025,76499
1992,KS,3,113566,115805,76569,305940,76569
1992,KS,4,113714,93656,76916,284286,76916
1992,KY,1,96602,116637,30869,244108,30869
1992,KY,2,107318,99054,33187,239559,33187
1992,KY,3,105520,143824,35902,285246,35902
1992,KY,4,106685,94323,40437,241445,40437
1992,KY,5,95843,109607,23890,229340,23890
1992,KY,6,105210,101659,39659,246528,39659
1992,LA,1,154584,87429,35725,277738,35725
1992,LA,2,55362,153134,15334,223830,15334
1992,LA,3,105982,115063,42757,263802,42757
1992,LA,4,57286,150800,21025,229111,21025
1992,LA,5,125965,94936,42149,263050,42149
1992,LA,6,134222,91273,40691,266186,40691
1992,LA,7,99985,123336,42723,266044,42723
1992,ME,1,115697,145191,104312,365200,104312
1992,ME,2,90807,118229,105263,314299,105263
1992,MD,1,109039,93165,48032,250236,48032
1992,MD,2,121087,98267,53526,272880,53526
1992,MD,3,82494,136829,35807,255130,35807
1992,MD,4,37716,149262,15420,202398,15420
1992,MD,5,95356,107618,38634,241608,38634
1992,MD,6,125494,88196,47151,260841,47151
1992,MD,7,32431,159191,14078,205700,14078
1992,MD,8,103477,156043,36340,295860,36340
1992,MA,1,72238,130308,70178,272724,70178
1992,MA,2,76277,121759,67280,265316,67280
1992,MA,3,85047,123724,64093,272864,64093
1992,MA,4,74769,143595,64333,282697,64333
1992,MA,5,85366,113073,72378,270817,72378
1992,MA,6,96857,134424,77874,309155,77874
1992,MA,7,87418,150073,63922,301413,63922
1992,MA,8,39368,136438,27342,203148,27342
1992,MA,9,85901,131644,57992,275537,57992
1992,MA,10,101798,133601,82519,317918,82519
1992,MI,1,101110,118983,65402,285495,65402
1992,MI,2,126969,95351,58238,280558,58238
1992,MI,3,128670,94715,52773,276158,52773
1992,MI,4,102284,104228,67263,273775,67263
1992,MI,5,85603,119086,61544,266233,61544
1992,MI,6,97234,100677,55682,253593,55682
1992,MI,7,96253,96872,62657,255782,62657
1992,MI,8,104437,118391,68340,291168,68340
1992,MI,9,92262,117872,55077,265211,55077
1992,MI,10,115849,100587,60927,277363,60927
1992,MI,11,147786,116266,50385,314437,50385
1992,MI,12,115065,119055,49519,283639,49519
1992,MI,13,89040,129113,43946,262099,43946
1992,MI,14,31360,165363,11992,208715,11992
1992,MI,15,24552,159284,8998,192834,8998
1992,MI,16,96466,115339,52070,263875,52070
1992,MN,1,98384,109829,75227,283440,75227
1992,MN,2,97867,103246,79442,280555,79442
1992,MN,3,117975,129171,79877,327023,79877
1992,MN,4,79137,147266,58850,285253,58850
1992,MN,5,68072,167941,52374,288387,52374
1992,MN,6,102265,120759,82587,305611,82587
1992,MN,7,103624,104359,63610,271593,63610
1992,MN,8,80517,138426,70539,289482,70539
1992,MS,1,101252,84765,17984,204001,17984
1992,MS,2,66905,105185,9879,181969,9879
1992,MS,3,116973,67411,16049,200433,16049
1992,MS,4,102666,84089,16758,203513,16758
1992,MS,5,99997,58808,24956,183761,24956
1992,MO,1,45231,161447,29682,236360,29682
1992,MO,2,126621,114612,72885,314118,72885
1992,MO,3,87155,121213,64415,272783,64415
1992,MO,4,96770,94948,65233,256951,65233
1992,MO,5,67511,134862,55799,258172,55799
1992,MO,6,88980,110137,75150,274267,75150
1992,MO,7,118817,96621,48824,264262,48824
1992,MO,8,89238,109858,41558,240654,41558
1992,MO,9,90836,110175,65195,266206,65195
1992,MT,AL,144207,154507,111897,410611,111897
1992,NE,1,107360,80938,61227,249525,61227
1992,NE,2,115380,78816,49686,243882,49686
1992,NE,3,121606,57590,66675,245871,66675
1992,NV,1,70440,98700,55964,225104,55964
1992,NV,2,105388,90448,76616,272452,76616
1992,NH,1,104653,101415,63583,269651,63583
1992,NH,2,97831,107625,62108,267564,62108
1992,NJ,1,78095,118060,48252,244407,48252
1992,NJ,2,97696,101718,50773,250187,50773
1992,NJ,3,113583,114503,54996,283082,54996
1992,NJ,4,109907,105335,50721,265963,50721
1992,NJ,5,146004,99733,48661,294398,48661
1992,NJ,6,98397,110821,41867,251085,41867
1992,NJ,7,125592,115846,40690,282128,40690
1992,NJ,8,99974,107304,27703,234981,27703
1992,NJ,9,102578,122676,31534,256788,31534
1992,NJ,10,36299,126415,14887,177601,14887
1992,NJ,11,153731,97697,46407,297835,46407
1992,NJ,12,130651,121447,50357,302455,50357
1992,NJ,13,64358,94651,14981,173990,14981
1992,NM,1,81038,95754,33034,209826,33034
1992,NM,2,68754,70630,31780,171164,31780
1992,NM,3,63032,95233,27081,185346,27081
1992,NY,1,101160,96890,54128,252178,54128
1992,NY,2,92762,91430,44603,228795,44603
1992,NY,3,121176,126112,40450,287738,40450
1992,NY,4,106016,119947,30476,256439,30476
1992,NY,5,88505,131042,30459,250006,30459
1992,NY,6,28033,115526,9380,152939,9380
1992,NY,7,57343,91319,14979,163641,14979
1992,NY,8,37558,168838,12197,218593,12197
1992,NY,9,67034,121361,17606,206001,17606
1992,NY,10,19200,125300,5720,150220,5720
1992,NY,11,11686,104584,3907,120177,3907
1992,NY,12,25664,67274,5133,98071,5133
1992,NY,13,100761,82796,26317,209874,26317
1992,NY,14,53830,160596,16467,230893,16467
1992,NY,15,15505,123846,4700,144051,4700
1992,NY,16,19029,101195,4123,124347,4123
1992,NY,17,30215,119964,7961,158140,7961
1992,NY,18,94652,117572,21986,234210,21986
1992,NY,19,109965,104949,45088,260002,45088
1992,NY,20,107107,116694,37014,260815,37014
1992,NY,21,99094,140251,51086,290431,51086
1992,NY,22,116283,99984,62533,278800,62533
1992,NY,23,99495,92554,55887,247936,55887
1992,NY,24,86311,85078,54537,225926,54537
1992,NY,25,95476,108335,58232,262043,58232
1992,NY,26,91462,116450,53675,261587,53675
1992,NY,27,115432,90194,67721,273347,67721
1992,NY,28,103544,119055,48467,271066,48467
1992,NY,29,86730,103528,70231,260489,70231
1992,NY,30,73333,119115,68174,260622,68174
1992,NY,31,97447,82671,62325,242443,62325
1992,NC,1,53019,109657,18266,180942,18266
1992,NC,2,99256,88141,30669,218066,30669
1992,NC,3,89877,74702,28195,192774,28195
1992,NC,4,105612,126577,38878,271067,38878
1992,NC,5,99408,98056,30631,228095,30631
1992,NC,6,119874,75651,38180,233705,38180
1992,NC,7,70159,71334,22194,163687,22194
1992,NC,8,86493,81736,27296,195525,27296
1992,NC,9,130798,81731,36454,248983,36454
1992,NC,10,127910,76262,35572,239744,35572
1992,NC,11,103849,105006,34643,243498,34643
1992,NC,12,48406,125189,16886,190481,16886
1992,ND,AL,136244,99168,72721,308133,72721
1992,OH,1,104339,104494,34531,243364,34531
1992,OH,2,143964,78117,51356,273437,51356
1992,OH,3,104215,107659,47465,259339,47465
1992,OH,4,118142,77975,58900,255017,58900
1992,OH,5,108421,88773,66051,263245,66051
1992,OH,6,102481,99761,50532,252774,50532
1992,OH,7,112701,84098,54307,251106,54307
1992,OH,8,121174,75375,60172,256721,60172
1992,OH,9,81784,118713,50151,250648,50151
1992,OH,10,92846,107465,58092,258403,58092
1992,OH,11,37886,169870,23428,231184,23428
1992,OH,12,108359,105852,47080,261291,47080
1992,OH,13,96037,101854,72038,269929,72038
1992,OH,14,81232,118715,60000,259947,60000
1992,OH,15,119588,94232,52316,266136,52316
1992,OH,16,98824,95157,60639,254620,60639
1992,OH,17,67858,131983,64339,264180,64339
1992,OH,18,87512,110491,58605,256608,58605
1992,OH,19,106947,114358,66424,287729,66424
1992,OK,1,122137,73509,52077,247723,52077
1992,OK,2,81432,96486,49124,227042,49124
1992,OK,3,77040,94753,55973,227766,55973
1992,OK,4,90975,72551,53894,217420,53894
1992,OK,5,129379,62251,59542,251172,59542
1992,OK,6,91966,73516,49268,214750,49268
1992,OR,1,99304,136630,73134,309068,73134
1992,OR,2,106696,97458,74346,278500,74346
1992,OR,3,72338,146835,58900,278073,58900
1992,OR,4,94032,123593,74640,292265,74640
1992,OR,5,103387,116798,73071,293256,73071
1992,PA,1,39086,150091,17052,206229,17052
1992,PA,2,31878,183758,14514,230150,14514
1992,PA,3,75388,125078,39582,240048,39582
1992,PA,4,76291,118701,50654,245646,50654
1992,PA,5,89385,78057,48100,215542,48100
1992,PA,6,90140,78776,50333,219249,50333
1992,PA,7,124751,111511,49798,286060,49798
1992,PA,8,99269,101630,56261,257160,56261
1992,PA,9,97764,66923,40200,204887,40200
1992,PA,10,95803,88193,46881,230877,46881
1992,PA,11,84199,91616,42950,218765,42950
1992,PA,12,72664,102768,44846,220278,44846
1992,PA,13,107439,118579,44148,270166,44148
1992,PA,14,66016,145419,38460,249895,38460
1992,PA,15,81349,92363,47740,221452,47740
1992,PA,16,109019,72724,43271,225014,43271
1992,PA,17,114245,72594,40495,227334,40495
1992,PA,18,80795,137507,46754,265056,46754
1992,PA,19,105647,75515,44373,225535,44373
1992,PA,20,69811,121823,48251,239885,48251
1992,PA,21,80902,105538,48004,234444,48004
1992,RI,1,62758,107141,51887,221786,51887
1992,RI,2,68843,106158,55146,230147,55146
1992,SC,1,101830,63318,26620,191768,26620
1992,SC,2,119658,82652,25853,228163,25853
1992,SC,3,101962,69161,26424,197547,26424
1992,SC,4,107970,65106,24131,197207,24131
1992,SC,5,86118,81192,23462,190772,23462
1992,SC,6,59970,118085,12292,190347,12292
1992,SD,AL,136718,124888,74648,336254,74648
1992,TN,1,107515,76113,24358,207986,24358
1992,TN,2,107920,92752,25157,225829,25157
1992,TN,3,97073,97112,25719,219904,25719
1992,TN,4,83923,100292,23838,208053,23838
1992,TN,5,79398,112795,21531,213724,21531
1992,TN,6,93036,109895,28151,231082,28151
1992,TN,7,114544,91644,22486,228674,22486
1992,TN,8,89533,101328,19328,210189,19328
1992,TN,9,68358,151590,9400,229348,9400
1992,TX,1,84545,85771,50567,220883,50567
1992,TX,2,76365,91731,47157,215253,47157
1992,TX,3,133834,58398,84097,276329,84097
1992,TX,4,95182,65522,69648,230352,69648
1992,TX,5,59588,70298,45131,175017,45131
1992,TX,6,127158,65846,83633,276637,83633
1992,TX,7,137541,52501,49201,239243,49201
1992,TX,8,134184,55917,55199,245300,55199
1992,TX,9,80813,98959,47418,227190,47418
1992,TX,10,84560,128813,54304,267677,54304
1992,TX,11,75545,66440,42305,184290,42305
1992,TX,12,70522,76637,55951,203110,55951
1992,TX,13,87492,73454,41187,202133,41187
1992,TX,14,86225,78706,47119,212050,47119
1992,TX,15,52102,80135,19995,152232,19995
1992,TX,16,45367,65614,18779,129760,18779
1992,TX,17,86490,73388,55834,215712,55834
1992,TX,18,40208,118493,20416,179117,20416
1992,TX,19,130639,50815,36068,217522,36068
1992,TX,20,57977,81381,28968,168326,28968
1992,TX,21,144073,70677,63454,278204,63454
1992,TX,22,116557,63092,50705,230354,50705
1992,TX,23,70576,72452,28846,171874,28846
1992,TX,24,59372,73635,46571,179578,46571
1992,TX,25,64962,85412,32515,182889,32515
1992,TX,26,118519,52727,81424,252670,81424
1992,TX,27,58780,78441,27468,164689,27468
1992,TX,28,51292,94113,27202,172607,27202
1992,TX,29,31839,54344,18427,104610,18427
1992,TX,30,33764,98103,25192,157059,25192
1992,UT,1,115627,50622,81873,248122,81873
1992,UT,2,101169,81233,83295,265697,83295
1992,UT,3,105836,51574,72840,230250,72840
1992,VT,AL,88122,133592,67987,289701,67987
1992,VA,1,120131,81826,41745,243702,41745
1992,VA,2,85773,62946,31266,179985,31266
1992,VA,3,48843,124857,18500,192200,18500
1992,VA,4,106392,90641,33313,230346,33313
1992,VA,5,104236,90769,30088,225093,30088
1992,VA,6,111405,84037,31699,227141,31699
1992,VA,7,154575,85357,44257,284189,44257
1992,VA,8,96799,133183,30202,260184,30202
1992,VA,9,93673,99099,29488,222260,29488
1992,VA,10,124783,83214,43078,251075,43078
1992,VA,11,103907,102721,35862,242490,35862
1992,WA,1,90537,118386,70340,279263,70340
1992,WA,2,85876,103405,71794,261075,71794
1992,WA,3,82648,104682,61609,248939,61609
1992,WA,4,87995,71914,45256,205165,45256
1992,WA,5,90294,99676,56472,246442,56472
1992,WA,6,77539,106370,60582,244491,60582
1992,WA,7,54478,191781,45167,291426,45167
1992,WA,8,92274,102859,72523,267656,72523
1992,WA,9,69593,93964,58037,221594,58037
1992,WV,1,86131,113756,46427,246314,46427
1992,WV,2,90375,104257,37529,232161,37529
1992,WV,3,65468,112988,26746,205202,26746
1992,WI,1,94712,109790,62465,266967,62465
1992,WI,2,94368,149340,52552,296260,52552
1992,WI,3,90813,119721,67134,277668,67134
1992,WI,4,108761,116048,59263,284072,59263
1992,WI,5,76935,142047,32138,251120,32138
1992,WI,6,114517,97121,69339,280977,69339
1992,WI,7,93156,117203,67558,277917,67558
1992,WI,8,115128,101493,69373,285994,69373
1992,WI,9,142465,88303,64657,295425,64657
1992,WY,AL,79347,68160,53118,200625,53118
1996,AL,1,112999,83920,14660,211579,14660
1996,AL,2,121306,81148,12691,215145,12691
1996,AL,3,97798,88156,13112,199066,13112
1996,AL,4,101636,91625,17687,210948,17687
1996,AL,5,111652,98401,18403,228456,18403
1996,AL,6,169870,68545,10995,249410,10995
1996,AL,7,53565,150271,5080,208916,5080
1996,AK,AL,122746,80380,38494,241620,38494
1996,AZ,1,109137,107698,17048,233883,17048
1996,AZ,2,36584,81678,9292,127554,9292
1996,AZ,3,130887,113635,26993,271515,26993
1996,AZ,4,115094,103878,16547,235519,16547
1996,AZ,5,116965,126223,20732,263920,20732
1996,AZ,6,113406,120176,21462,255044,21462
1996,AR,1,65707,116634,18857,201198,18857
1996,AR,2,83218,124545,17656,225419,17656
1996,AR,3,110457,107096,26857,244410,26857
1996,AR,4,66034,126896,18624,211554,18624
1996,CA,1,83669,113861,38723,236253,38723
1996,CA,2,126430,89736,32223,248389,32223
1996,CA,3,101651,103507,23781,228939,23781
1996,CA,4,145223,107076,31011,283310,31011
1996,CA,5,70925,119678,19022,209625,19022
1996,CA,6,78166,155513,39631,273310,39631
1996,CA,7,50140,131707,19499,201346,19499
1996,CA,8,31282,114906,27957,174145,27957
1996,CA,9,26321,156998,25775,209094,25775
1996,CA,10,122296,138386,26305,286987,26305
1996,CA,11,84303,85117,16560,185980,16560
1996,CA,12,58260,191973,22285,272518,22285
1996,CA,13,51084,115633,18928,185645,18928
1996,CA,14,73302,137561,27132,237995,27132
1996,CA,15,83846,125438,28661,237945,28661
1996,CA,16,43257,91786,14854,149897,14854
1996,CA,17,64178,109941,24818,198937,24818
1996,CA,18,76217,77560,15631,169408,15631
1996,CA,19,111666,85744,17315,214725,17315
1996,CA,20,48446,62164,8201,118811,8201
1996,CA,21,109344,66492,18513,194349,18513
1996,CA,22,108722,108208,28972,245902,28972
1996,CA,23,85508,93046,25982,204536,25982
1996,CA,24,83412,117724,24219,225355,24219
1996,CA,25,97002,84212,24095,205309,24095
1996,CA,26,27129,71416,11080,109625,11080
1996,CA,27,81282,98348,20864,200494,20864
1996,CA,28,86358,88709,20656,195723,20656
1996,CA,29,53354,150771,22641,226766,22641
1996,CA,30,17053,61114,7878,86045,7878
1996,CA,31,27736,70288,9511,107535,9511
1996,CA,32,19348,130394,10618,160360,10618
1996,CA,33,8538,48636,3837,61011,3837
1996,CA,34,39277,91603,13326,144206,13326
1996,CA,35,12063,92773,5856,110692,5856
1996,CA,36,96872,109244,27885,234001,27885
1996,CA,37,13874,88877,6328,109079,6328
1996,CA,38,62053,91673,19782,173508,19782
1996,CA,39,97247,83246,20750,201243,20750
1996,CA,40,94916,73316,26186,194418,26186
1996,CA,41,76867,71393,16739,164999,16739
1996,CA,42,51106,76745,15671,143522,15671
1996,CA,43,82940,78384,21093,182417,21093
1996,CA,44,86414,85397,21744,193555,21744
1996,CA,45,108240,81299,24803,214342,24803
1996,CA,46,42780,51330,10838,104948,10838
1996,CA,47,137024,91916,24886,253826,24886
1996,CA,48,132545,80646,25193,238384,25193
1996,CA,49,91478,110920,24598,226996,24598
1996,CA,50,42730,78881,10529,132140,10529
1996,CA,51,130459,97128,24881,252468,24881
1996,CA,52,94035,81401,22188,197624,22188
1996,CO,1,66427,133032,18043,217502,18043
1996,CO,2,102107,127702,28679,258488,28679
1996,CO,3,122826,116628,32282,271736,32282
1996,CO,4,122840,102355,25327,250522,25327
1996,CO,5,158790,88057,22511,269358,22511
1996,CO,6,118856,103376,18432,240664,18432
1996,CT,1,68483,136775,26066,231324,26066
1996,CT,2,73863,123595,36781,234239,36781
1996,CT,3,71009,129756,28447,229212,28447
1996,CT,4,88181,113411,20180,221772,20180
1996,CT,5,92570,110596,28959,232125,28959
1996,CT,6,89003,121607,33327,243937,33327
1996,DE,AL,99062,140355,31667,271084,31667
1996,DC,AL,17339,158220,10167,185726,10167
1996,FL,1,146794,77070,24322,248186,24322
1996,FL,2,99487,114601,25455,239543,25455
1996,FL,3,66057,110701,12633,189391,12633
1996,FL,4,145760,94843,19071,259674,19071
1996,FL,5,100603,135496,34973,271072,34973
1996,FL,6,124489,96135,27762,248386,27762
1996,FL,7,108636,100603,22863,232102,22863
1996,FL,8,95300,88306,17231,200837,17231
1996,FL,9,119658,118996,27335,265989,27335
1996,FL,10,89928,120716,23579,234223,23579
1996,FL,11,75004,98028,14849,187881,14849
1996,FL,12,96140,89296,20770,206206,20770
1996,FL,13,133005,122884,29634,285523,29634
1996,FL,14,140921,105027,29735,275683,29735
1996,FL,15,125430,111263,34594,271287,34594
1996,FL,16,116630,131252,29321,277203,29321
1996,FL,17,16802,115732,3944,136478,3944
1996,FL,18,86005,71673,7788,165466,7788
1996,FL,19,81020,189336,20094,290450,20094
1996,FL,20,78699,148289,23296,250284,23296
1996,FL,21,82384,72844,7901,163129,7901
1996,FL,22,86668,124715,17418,228801,17418
1996,FL,23,27531,107884,9193,144608,9193
1996,GA,1,87895,81804,11491,181190,11491
1996,GA,2,72934,82429,11494,166857,11494
1996,GA,3,104286,87911,13550,205747,13550
1996,GA,4,69912,141078,8014,219004,8014
1996,GA,5,41346,134597,4980,180923,4980
1996,GA,6,186084,100714,15416,302214,15416
1996,GA,7,99320,77741,16603,193664,16603
1996,GA,8,85224,90662,14643,190529,14643
1996,GA,9,115306,73861,20809,209976,20809
1996,GA,10,90213,94968,11669,196850,11669
1996,GA,11,128320,88083,17668,234071,17668
1996,HI,1,58906,99351,16262,174519,16262
1996,HI,2,55037,105661,24907,185605,24907
1996,ID,1,134783,91297,37272,263352,37272
1996,ID,2,121812,74146,32401,228359,32401
1996,IL,1,22914,179767,6378,209059,6378
1996,IL,2,22204,170819,6395,199418,6395
1996,IL,3,78853,114089,19441,212383,19441
1996,IL,4,14661,82225,5160,102046,5160
1996,IL,5,56532,120132,12915,189579,12915
1996,IL,6,105797,93358,18796,217951,18796
1996,IL,7,25757,152606,5037,183400,5037
1996,IL,8,105742,86907,19482,212131,19482
1996,IL,9,52263,139166,9732,201161,9732
1996,IL,10,97434,112105,13418,222957,13418
1996,IL,11,83648,112110,23162,218920,23162
1996,IL,12,72652,120389,19777,212818,19777
1996,IL,13,126594,104713,21701,253008,21701
1996,IL,14,103773,89939,22148,215860,22148
1996,IL,15,98926,100016,19478,218420,19478
1996,IL,16,111641,99397,24153,235191,24153
1996,IL,17,89447,119918,23176,232541,23176
1996,IL,18,118572,112678,20975,252225,20975
1996,IL,19,97977,113635,28653,240265,28653
1996,IL,20,101634,117775,26431,245840,26431
1996,IN,1,62595,116355,19530,198480,19530
1996,IN,2,97406,89038,26483,212927,26483
1996,IN,3,91427,86715,20374,198516,20374
1996,IN,4,110538,75185,19641,205364,19641
1996,IN,5,105906,78270,27469,211645,27469
1996,IN,6,168497,75285,22404,266186,22404
1996,IN,7,111500,75150,25773,212423,25773
1996,IN,8,96956,100171,23905,221032,23905
1996,IN,9,99915,101434,26154,227503,26154
1996,IN,10,61892,89851,12547,164290,12547
1996,IA,1,92207,135839,23436,251482,23436
1996,IA,2,91155,129148,23653,243956,23653
1996,IA,3,95308,123246,25984,244538,25984
1996,IA,4,107359,127250,23083,257692,23083
1996,IA,5,106615,104775,25017,236407,25017
1996,KS,1,167237,75840,27070,270147,27070
1996,KS,2,125087,100110,30235,255432,30235
1996,KS,3,144924,121152,21571,287647,21571
1996,KS,4,145997,90557,24326,260880,24326
1996,KY,1,96356,105150,22727,224233,22727
1996,KY,2,113923,95530,22021,231474,22021
1996,KY,3,101977,134975,17230,254182,17230
1996,KY,4,115187,95070,20733,230990,20733
1996,KY,5,87692,95633,18260,201585,18260
1996,KY,6,108148,110256,19425,237829,19425
1996,LA,1,152655,100655,18991,272301,18991
1996,LA,2,40739,169930,7148,217817,7148
1996,LA,3,120605,153925,25529,300059,25529
1996,LA,4,92741,122729,20290,235760,20290
1996,LA,5,113846,132407,26987,273240,26987
1996,LA,6,121851,142156,21821,285828,21821
1996,LA,7,70149,106034,22640,198823,22640
1996,ME,1,100851,165053,51217,317121,51217
1996,ME,2,85527,147735,55514,288776,55514
1996,MD,1,107122,97338,20779,225239,20779
1996,MD,2,119178,95112,22412,236702,22412
1996,MD,3,72017,123532,13872,209421,13872
1996,MD,4,30071,152396,5591,188058,5591
1996,MD,5,95737,117345,14546,227628,14546
1996,MD,6,130321,96185,21205,247711,21205
1996,MD,7,23757,127850,5207,156814,5207
1996,MD,8,103327,156450,12200,271977,12200
1996,MA,1,63998,151531,33834,249363,33834
1996,MA,2,66344,147670,28205,242219,28205
1996,MA,3,76082,154495,28604,259181,28604
1996,MA,4,69548,169078,26328,264954,26328
1996,MA,5,76896,143463,28273,248632,28273
1996,MA,6,86306,166037,30423,282766,30423
1996,MA,7,71875,169231,23620,264726,23620
1996,MA,8,31241,140733,13059,185033,13059
1996,MA,9,73214,157617,22106,252937,22106
1996,MA,10,101612,169927,32164,303703,32164
1996,MI,1,107577,125135,31184,263896,31184
1996,MI,2,133022,108242,23512,264776,23512
1996,MI,3,135759,99698,17583,253040,17583
1996,MI,4,98215,112625,28350,239190,28350
1996,MI,5,90107,155995,27477,273579,27477
1996,MI,6,99975,103454,19967,223396,19967
1996,MI,7,99518,105185,24501,229204,24501
1996,MI,8,111811,135653,25949,273413,25949
1996,MI,9,89538,95473,21567,206578,21567
1996,MI,10,96592,120921,27083,244596,27083
1996,MI,11,131571,134344,19322,285237,19322
1996,MI,12,95071,128820,20612,244503,20612
1996,MI,13,76165,135250,20944,232359,20944
1996,MI,14,20915,160009,4772,185696,4772
1996,MI,15,17275,146357,3723,167355,3723
1996,MI,16,78461,122522,24125,225108,24125
1996,MN,1,97050,127730,35408,260188,35408
1996,MN,2,105205,120652,38117,263974,38117
1996,MN,3,125019,141109,36553,302681,36553
1996,MN,4,77704,152555,31254,261513,31254
1996,MN,5,62507,159018,33135,254660,33135
1996,MN,6,107560,154333,42312,304205,42312
1996,MN,7,103336,115996,37656,256988,37656
1996,MN,8,88095,148886,44552,281533,44552
1996,MS,1,90604,78894,17559,187057,17559
1996,MS,2,58177,104639,5714,168530,5714
1996,MS,3,107292,66027,9733,183052,9733
1996,MS,4,86880,83425,9648,179953,9648
1996,MS,5,96880,61035,13431,171346,13431
1996,MO,1,38505,145586,9721,193812,9721
1996,MO,2,138401,115698,22791,276890,22791
1996,MO,3,93190,115141,29247,237578,29247
1996,MO,4,111172,99975,29011,240158,29011
1996,MO,5,71453,127691,17489,216633,17489
1996,MO,6,105084,115342,29302,249728,29302
1996,MO,7,129249,93537,27580,250366,27580
1996,MO,8,96457,101339,25089,222885,25089
1996,MO,9,106503,111626,30593,248722,30593
1996,MT,AL,179652,167922,59687,407261,59687
1996,NE,1,114563,87712,28055,230330,28055
1996,NE,2,116889,84667,21100,222656,21100
1996,NE,3,132015,64382,28028,224425,28028
1996,NV,1,65990,91307,21760,179057,21760
1996,NV,2,133254,112667,39356,285277,39356
1996,NH,1,101295,121602,27032,249929,27032
1996,NH,2,95237,124612,27822,247671,27822
1996,NJ,1,61294,132715,30174,224183,30174
1996,NJ,2,84043,117526,32053,233622,32053
1996,NJ,3,101100,134326,33126,268552,33126
1996,NJ,4,92845,127489,31589,251923,31589
1996,NJ,5,127286,115060,28732,271078,28732
1996,NJ,6,74937,122851,28160,225948,28160
1996,NJ,7,101538,129773,24479,255790,24479
1996,NJ,8,73731,123856,16959,214546,16959
1996,NJ,9,71741,138242,17012,226995,17012
1996,NJ,10,21911,138128,5774,165813,5774
1996,NJ,11,135972,116225,26616,278813,26616
1996,NJ,12,120913,139252,29875,290040,29875
1996,NJ,13,35266,115576,11175,162017,11175
1996,NM,1,82613,93178,16732,192523,16732
1996,NM,2,77634,80572,15298,173504,15298
1996,NM,3,72504,99745,17807,190056,17807
1996,NY,1,83956,118187,29919,232062,29919
1996,NY,2,68710,108598,23536,200844,23536
1996,NY,3,97034,136034,22829,255897,22829
1996,NY,4,83750,131825,14493,230068,14493
1996,NY,5,71194,132588,17394,221176,17394
1996,NY,6,15946,128071,4380,148397,4380
1996,NY,7,37230,99813,10085,147128,10085
1996,NY,8,30141,147864,14128,192133,14128
1996,NY,9,47498,113939,11776,173213,11776
1996,NY,10,9059,134057,5948,149064,5948
1996,NY,11,7832,116390,4554,128776,4554
1996,NY,12,10249,80852,4338,95439,4338
1996,NY,13,72233,92619,15043,179895,15043
1996,NY,14,46970,144885,14325,206180,14325
1996,NY,15,7658,135845,6069,149572,6069
1996,NY,16,4825,117624,1862,124311,1862
1996,NY,17,16238,126787,3844,146869,3844
1996,NY,18,73399,121501,13930,208830,13930
1996,NY,19,98597,116697,25892,241186,25892
1996,NY,20,89214,130550,22545,242309,22545
1996,NY,21,79880,151701,32464,264045,32464
1996,NY,22,105106,117831,39534,262471,39534
1996,NY,23,88120,102854,32858,223832,32858
1996,NY,24,72301,102007,30047,204355,30047
1996,NY,25,90774,121304,27554,239632,27554
1996,NY,26,82044,120755,32366,235165,32366
1996,NY,27,111371,111804,36378,259553,36378
1996,NY,28,88279,136424,23822,248525,23822
1996,NY,29,82737,120777,31944,235458,31944
1996,NY,30,69341,137557,33236,240134,33236
1996,NY,31,91208,98244,33846,223298,33846
1996,NC,1,53582,105563,8229,167374,8229
1996,NC,2,111155,90623,12500,214278,12500
1996,NC,3,100123,75200,12393,187716,12393
1996,NC,4,130642,141051,14401,286094,14401
1996,NC,5,107237,87100,15376,209713,15376
1996,NC,6,133262,75904,18412,227578,18412
1996,NC,7,79082,71377,11917,162376,11917
1996,NC,8,91672,80296,14607,186575,14607
1996,NC,9,129088,89400,13880,232368,13880
1996,NC,10,136253,70751,17874,224878,17874
1996,NC,11,106513,97073,20681,224267,20681
1996,NC,12,47329,123511,7789,178629,7789
1996,ND,AL,125050,106905,34456,266411,34456
1996,OH,1,96103,110166,12842,219111,12842
1996,OH,2,153627,90571,19894,264092,19894
1996,OH,3,95003,115168,18194,228365,18194
1996,OH,4,118298,88758,28248,235304,28248
1996,OH,5,108255,102862,32365,243482,32365
1996,OH,6,101991,106479,28942,237412,28942
1996,OH,7,115393,100509,25373,241275,25373
1996,OH,8,125577,89331,26111,241019,26111
1996,OH,9,76613,125971,22960,225544,22960
1996,OH,10,83055,117878,26952,227885,26952
1996,OH,11,28938,155895,9553,194386,9553
1996,OH,12,114405,118228,16426,249059,16426
1996,OH,13,98349,116720,35527,250596,35527
1996,OH,14,76083,121635,30312,228030,30312
1996,OH,15,114183,105947,17324,237454,17324
1996,OH,16,98786,100293,33255,232334,33255
1996,OH,17,67705,142121,31494,241320,31494
1996,OH,18,86305,112851,36143,235299,36143
1996,OH,19,102099,126926,31362,260387,31362
1996,OK,1,115997,79518,19087,214602,19087
1996,OK,2,81558,97284,25928,204770,25928
1996,OK,3,77287,92007,24580,193874,24580
1996,OK,4,92011,75291,20376,187678,20376
1996,OK,5,128792,68222,20668,217682,20668
1996,OK,6,86670,75783,20149,182602,20149
1996,OR,1,112152,145540,35614,293306,35614
1996,OR,2,130408,103116,40455,273979,40455
1996,OR,3,72124,147056,36437,255617,36437
1996,OR,4,108780,122392,41913,273085,41913
1996,OR,5,114691,131527,35545,281763,35545
1996,PA,1,21845,148850,7519,178214,7519
1996,PA,2,20675,173723,5981,200379,5981
1996,PA,3,51781,114680,21748,188209,21748
1996,PA,4,96511,107017,23375,226903,23375
1996,PA,5,91619,80003,25687,197309,25687
1996,PA,6,89695,83779,25139,198613,25139
1996,PA,7,112429,116654,27985,257068,27985
1996,PA,8,99458,107500,30341,237299,30341
1996,PA,9,102847,70206,21239,194292,21239
1996,PA,10,91629,95712,24303,211644,24303
1996,PA,11,76969,97393,25597,199959,25597
1996,PA,12,81122,93532,25755,200409,25755
1996,PA,13,106461,125364,24101,255926,24101
1996,PA,14,70466,126704,19107,216277,19107
1996,PA,15,85736,96380,25255,207371,25255
1996,PA,16,114164,80476,18010,212650,18010
1996,PA,17,116473,81205,17997,215675,17997
1996,PA,18,89580,119943,19689,229212,19689
1996,PA,19,112221,81319,18972,212512,18972
1996,PA,20,85040,109299,23652,217991,23652
1996,PA,21,87448,106080,22510,216038,22510
1996,RI,1,48964,114858,24591,188413,24591
1996,RI,2,55719,118192,27806,201717,27806
1996,SC,1,107221,74150,11491,192862,11491
1996,SC,2,117261,90871,10827,218959,10827
1996,SC,3,100390,71755,13220,185365,13220
1996,SC,4,111699,74208,11496,197403,11496
1996,SC,5,83273,82203,11827,177303,11827
1996,SC,6,53614,113096,5525,172235,5525
1996,SD,AL,150543,139333,33950,323826,33950
1996,TN,1,107668,73681,14532,195881,14532
1996,TN,2,117248,95810,12522,225580,12522
1996,TN,3,93799,92780,13284,199863,13284
1996,TN,4,90135,92106,14816,197057,14816
1996,TN,5,82053,116987,9727,208767,9727
1996,TN,6,112827,107821,15375,236023,15375
1996,TN,7,122177,92802,10965,225944,10965
1996,TN,8,85856,98925,10835,195616,10835
1996,TN,9,51767,138234,3862,193863,3862
1996,TX,1,94433,91721,17237,203391,17237
1996,TX,2,89817,90379,19136,199332,19136
1996,TX,3,133044,72217,17778,223039,17778
1996,TX,4,117895,73873,18693,210461,18693
1996,TX,5,77002,78249,13355,168606,13355
1996,TX,6,144773,78617,17483,240873,17483
1996,TX,7,145637,61834,10338,217809,10338
1996,TX,8,155593,62641,14892,233126,14892
1996,TX,9,89942,97268,14144,201354,14144
1996,TX,10,93219,126855,13453,233527,13453
1996,TX,11,88429,74063,14671,177163,14671
1996,TX,12,79299,80709,14187,174195,14187
1996,TX,13,92815,69149,14030,175994,14030
1996,TX,14,100319,84317,15696,200332,15696
1996,TX,15,49595,86707,7093,143395,7093
1996,TX,16,40983,80475,5902,127360,5902
1996,TX,17,98804,76057,19182,194043,19182
1996,TX,18,37280,116059,5515,158854,5515
1996,TX,19,133397,51996,12323,197716,12323
1996,TX,20,48488,82892,7285,138665,7285
1996,TX,21,174072,81940,18474,274486,18474
1996,TX,22,119341,79683,12213,211237,12213
1996,TX,23,73282,83965,9372,166619,9372
1996,TX,24,59125,80626,10681,150432,10681
1996,TX,25,70344,81482,8331,160157,8331
1996,TX,26,153691,73675,17802,245168,17802
1996,TX,27,57533,87511,8094,153138,8094
1996,TX,28,47338,93147,8211,148696,8211
1996,TX,29,35809,65794,6331,107934,6331
1996,TX,30,34820,95715,6527,137062,6527
1996,UT,1,129273,64104,27441,220818,27441
1996,UT,2,111166,96037,28762,235965,28762
1996,UT,3,121472,61492,25881,208845,25881
1996,VT,AL,80352,137894,40203,258449,40203
1996,VA,1,125080,95853,19940,240873,19940
1996,VA,2,77943,71683,12877,162503,12877
1996,VA,3,36099,117357,9430,162886,9430
1996,VA,4,103368,101686,18108,223162,18108
1996,VA,5,104325,93040,20758,218123,20758
1996,VA,6,108757,87883,19587,216227,19587
1996,VA,7,155466,93025,18814,267305,18814
1996,VA,8,95839,130177,11663,237679,11663
1996,VA,9,85531,91469,23706,200706,23706
1996,VA,10,140684,99510,19388,259582,19388
1996,VA,11,105258,109377,12961,227596,12961
1996,WA,1,103002,140182,31879,275063,31879
1996,WA,2,103901,123729,38232,265862,38232
1996,WA,3,97985,124864,34302,257151,34302
1996,WA,4,101963,84157,25384,211504,25384
1996,WA,5,102384,104052,32076,238512,32076
1996,WA,6,87961,122342,32798,243101,32798
1996,WA,7,53437,182671,36938,273046,36938
1996,WA,8,112463,130472,32587,275522,32587
1996,WA,9,77616,110854,27272,215742,27272
1996,WV,1,83306,107835,30037,221178,30037
1996,WV,2,88930,108503,24426,221859,24426
1996,WV,3,61710,111474,20238,193422,20238
1996,WI,1,88599,117308,30310,236217,30310
1996,WI,2,88072,146819,34425,269316,34425
1996,WI,3,82678,120717,38599,241994,38599
1996,WI,4,94003,115466,26405,235874,26405
1996,WI,5,58560,126179,15785,200524,15785
1996,WI,6,99650,108004,32739,240393,32739
1996,WI,7,86374,119984,39585,245943,39585
1996,WI,8,105131,116073,32429,253633,32429
1996,WI,9,141961,101420,28914,272295,28914
1996,WY,AL,105388,77934,28249,211571,28249
2000,AL,1,140793,88315,4866,233974,4866
2000,AL,2,145607,82223,3598,231428,3598
2000,AL,3,126342,91871,4245,222458,4245
2000,AL,4,137853,90502,4318,232673,4318
2000,AL,5,139343,108333,5714,253390,5714
2000,AL,6,196302,81027,6826,284155,6826
2000,AL,7,54932,150339,1893,207164,1893
2000,AK,AL,167398,79004,39158,285560,39158
2000,AZ,1,127057,108920,10957,246934,10957
2000,AZ,2,43017,78169,5770,126956,5770
2000,AZ,3,177572,126950,13099,317621,13099
2000,AZ,4,121685,101960,9240,232885,9240
2000,AZ,5,143178,135963,14549,293690,14549
2000,AZ,6,169143,133379,11158,313680,11158
2000,AR,1,96009,102644,4828,203481,4828
2000,AR,2,116075,112720,6817,235612,6817
2000,AR,3,160001,100297,9087,269385,9087
2000,AR,4,100855,107107,5341,213303,5341
2000,CA,1,101630,124039,22391,248060,22391
2000,CA,2,155841,89859,17661,263361,17661
2000,CA,3,122587,104639,12620,239846,12620
2000,CA,4,189521,120519,16184,326224,16184
2000,CA,5,81592,126007,13142,220741,13142
2000,CA,6,88144,181497,23384,293025,23384
2000,CA,7,57930,148302,9658,215890,9658
2000,CA,8,36122,190112,21595,247829,21595
2000,CA,9,27154,177840,21220,226214,21220
2000,CA,10,141285,161773,12087,315145,12087
2000,CA,11,106466,99901,7934,214301,7934
2000,CA,12,63534,156672,12385,232591,12385
2000,CA,13,57042,127994,7870,192906,7870
2000,CA,14,77773,150035,13531,241339,13531
2000,CA,15,92230,138407,13594,244231,13594
2000,CA,16,53502,108515,6986,169003,6986
2000,CA,17,70750,127791,15968,214509,15968
2000,CA,18,97175,81179,6363,184717,6363
2000,CA,19,132193,87661,9660,229514,9660
2000,CA,20,60989,63592,3503,128084,3503
2000,CA,21,129401,67577,6529,203507,6529
2000,CA,22,126180,115221,17206,258607,17206
2000,CA,23,107859,110746,11303,229908,11303
2000,CA,24,94235,144778,10820,249833,10820
2000,CA,25,120463,104593,9120,234176,9120
2000,CA,26,32004,88710,5394,126108,5394
2000,CA,27,92278,118944,11540,222762,11540
2000,CA,28,101698,106203,8874,216775,8874
2000,CA,29,56705,183361,14282,254348,14282
2000,CA,30,20626,80011,6046,106683,6046
2000,CA,31,34389,86956,4176,125521,4176
2000,CA,32,22852,146706,6389,175947,6389
2000,CA,33,11402,63370,1990,76762,1990
2000,CA,34,46974,107003,5013,158990,5013
2000,CA,35,14605,104812,2663,122080,2663
2000,CA,36,110507,126440,12562,249509,12562
2000,CA,37,17777,99748,2871,120396,2871
2000,CA,38,70439,109436,9113,188988,9113
2000,CA,39,114680,93977,8267,216924,8267
2000,CA,40,116349,81703,9665,207717,9665
2000,CA,41,95093,88174,6227,189494,6227
2000,CA,42,62058,89955,5940,157953,5940
2000,CA,43,111212,94293,7999,213504,7999
2000,CA,44,106011,100754,7929,214694,7929
2000,CA,45,128175,91915,10551,230641,10551
2000,CA,46,50505,64569,4267,119341,4267
2000,CA,47,165909,112136,10650,288695,10650
2000,CA,48,169514,100148,11142,280804,11142
2000,CA,49,97785,123997,13878,235660,13878
2000,CA,50,53898,85408,5523,144829,5523
2000,CA,51,156855,115219,12145,284219,12145
2000,CA,52,115402,87365,9370,212137,9370
2000,CO,1,70219,134384,15548,220151,15548
2000,CO,2,126025,144391,28530,298946,28530
2000,CO,3,166037,121025,24081,311143,24081
2000,CO,4,167264,111632,18591,297487,18591
2000,CO,5,213207,107851,15888,336946,15888
2000,CO,6,141001,118946,15559,275506,15559
2000,CT,1,77423,148858,12634,238915,12634
2000,CT,2,92844,137128,17310,247282,17310
2000,CT,3,82344,146540,14959,243843,14959
2000,CT,4,94079,125843,9715,229637,9715
2000,CT,5,107360,123207,12869,243436,12869
2000,CT,6,107044,134439,14875,256358,14875
2000,DE,AL,137288,180068,10266,327622,10266
2000,DC,AL,18073,171923,11898,201894,11898
2000,FL,1,190045,83681,6607,280333,6607
2000,FL,2,129884,127360,6161,263405,6161
2000,FL,3,68252,101900,2719,172871,2719
2000,FL,4,193015,108502,6490,308007,6490
2000,FL,5,136812,147973,10914,295699,10914
2000,FL,6,175421,113876,6625,295922,6625
2000,FL,7,141119,132634,5820,279573,5820
2000,FL,8,126117,121937,5065,253119,5065
2000,FL,9,165956,142098,8918,316972,8918
2000,FL,10,107504,129502,8318,245324,8318
2000,FL,11,92335,110055,6194,208584,6194
2000,FL,12,127693,98718,4509,230920,4509
2000,FL,13,160229,137596,8929,306754,8929
2000,FL,14,188735,121686,7437,317858,7437
2000,FL,15,165529,136685,7899,310113,7899
2000,FL,16,146350,155368,6835,308553,6835
2000,FL,17,21890,122462,1057,145409,1057
2000,FL,18,110807,68121,2348,181276,2348
2000,FL,19,97222,225276,6195,328693,6195
2000,FL,20,105032,184297,5452,294781,5452
2000,FL,21,126991,74304,2022,203317,2022
2000,FL,22,94355,140127,5267,239749,5267
2000,FL,23,29936,119258,2327,151521,2327
2000,GA,1,114287,84105,1426,199818,1426
2000,GA,2,97856,82125,1213,181194,1213
2000,GA,3,139314,103434,4502,247250,4502
2000,GA,4,67409,157339,5456,230204,5456
2000,GA,5,44435,142016,1579,188030,1579
2000,GA,6,236597,115465,8385,360447,8385
2000,GA,7,137731,87656,4531,229918,4531
2000,GA,8,115823,86027,2153,204003,2153
2000,GA,9,178785,72703,5377,256865,5377
2000,GA,10,115657,93898,2056,211611,2056
2000,GA,11,171826,91462,8793,272081,8793
2000,HI,1,67784,95596,9840,173220,9840
2000,HI,2,70743,109646,14888,195277,14888
2000,ID,1,182498,77926,14442,274866,14442
2000,ID,2,154439,60711,11599,226749,11599
2000,IL,1,24357,194559,3700,222616,3700
2000,IL,2,22954,189472,2328,214754,2328
2000,IL,3,87792,117597,6778,212167,6778
2000,IL,4,22377,95459,5107,122943,5107
2000,IL,5,68824,129861,7786,206471,7786
2000,IL,6,122689,105348,7242,235279,7242
2000,IL,7,30849,176299,4292,211440,4292
2000,IL,8,138364,104145,6926,249435,6926
2000,IL,9,59031,156193,9031,224255,9031
2000,IL,10,110283,130763,5628,246674,5628
2000,IL,11,109022,129787,6454,245263,6454
2000,IL,12,96116,123593,6365,226074,6365
2000,IL,13,171242,132380,8375,311997,8375
2000,IL,14,144424,109991,8062,262477,8062
2000,IL,15,127193,105920,8126,241239,8126
2000,IL,16,149919,117841,8794,276554,8794
2000,IL,17,113518,126981,7100,247599,7100
2000,IL,18,147812,115737,6760,270309,6760
2000,IL,19,136985,107982,6128,251095,6128
2000,IL,20,135681,119151,7135,261967,7135
2000,IN,1,81799,126069,2367,210235,2367
2000,IN,2,118948,87240,3580,209768,3580
2000,IN,3,116355,88272,2774,207401,2774
2000,IN,4,135865,73931,3281,213077,3281
2000,IN,5,135422,81302,3679,220403,3679
2000,IN,6,200333,84589,4252,289174,4252
2000,IN,7,133818,78231,3611,215660,3611
2000,IN,8,126011,92112,2979,221102,2979
2000,IN,9,136878,94989,3038,234905,3038
2000,IN,10,60407,95245,2971,158623,2971
2000,IA,1,118268,147279,9934,275481,9934
2000,IA,2,117021,132318,7798,257137,7798
2000,IA,3,125784,122176,9077,257037,9077
2000,IA,4,140535,134668,7143,282346,7143
2000,IA,5,132765,102076,7256,242097,7256
2000,KS,1,170262,72319,12078,254659,12078
2000,KS,2,137329,101640,12425,251394,12425
2000,KS,3,166667,133632,15111,315410,15111
2000,KS,4,148074,91685,10994,250753,10994
2000,KY,1,142082,99887,3954,245923,3954
2000,KY,2,166262,95443,4667,266372,4667
2000,KY,3,125184,139039,6811,271034,6811
2000,KY,4,156327,95069,6162,257558,6162
2000,KY,5,127446,92989,3244,223679,3244
2000,KY,6,155219,116496,7745,279460,7745
2000,LA,1,186243,97006,6881,290130,6881
2000,LA,2,39195,152830,3851,195876,3851
2000,LA,3,138794,116234,7766,262794,7766
2000,LA,4,124894,99566,5099,229559,5099
2000,LA,5,140834,91397,6865,239096,6865
2000,LA,6,151029,123384,6210,280623,6210
2000,LA,7,146882,111927,7666,266475,7666
2000,ME,1,148618,176293,24023,348934,24023
2000,ME,2,137998,143658,21200,302856,21200
2000,MD,1,140217,117820,8719,266756,8719
2000,MD,2,148962,111627,9251,269840,9251
2000,MD,3,80250,149644,8698,238592,8698
2000,MD,4,28438,178977,5119,212534,5119
2000,MD,5,112510,149191,7749,269450,7749
2000,MD,6,169879,112214,9315,291408,9315
2000,MD,7,23215,140865,4568,168648,4568
2000,MD,8,110356,183670,10940,304966,10940
2000,MA,1,83994,144582,26762,255338,26762
2000,MA,2,85359,145490,18854,249703,18854
2000,MA,3,95943,159357,18257,273557,18257
2000,MA,4,85670,178381,18209,282260,18209
2000,MA,5,96718,149789,19066,265573,19066
2000,MA,6,107274,173000,20815,301089,20815
2000,MA,7,81311,174884,19582,275777,19582
2000,MA,8,34979,129033,20008,184020,20008
2000,MA,9,81465,181527,19492,282484,19492
2000,MA,10,125789,180444,22918,329151,22918
2000,MI,1,156812,126568,10303,293683,10303
2000,MI,2,178794,115018,7004,300816,7004
2000,MI,3,169423,109410,7221,286054,7221
2000,MI,4,147302,124549,7224,279075,7224
2000,MI,5,117784,137385,5923,261092,5923
2000,MI,6,125796,111276,7134,244206,7134
2000,MI,7,130363,115996,6753,253112,6753
2000,MI,8,143578,153417,9169,306164,9169
2000,MI,9,123236,142311,6683,272230,6683
2000,MI,10,144587,143675,7631,295893,7631
2000,MI,11,154674,155870,7634,318178,7634
2000,MI,12,111692,138838,7284,257814,7284
2000,MI,13,101327,153051,8337,262715,8337
2000,MI,14,21403,172098,1975,195476,1975
2000,MI,15,19262,139570,2080,160912,2080
2000,MI,16,107676,131830,6508,246014,6508
2000,MN,1,137562,132727,17913,288202,17913
2000,MN,2,158071,118432,17077,293580,17077
2000,MN,3,170412,154997,16751,342160,16751
2000,MN,4,101741,157582,20207,279530,20207
2000,MN,5,76389,170176,25583,272148,25583
2000,MN,6,176703,169478,19825,366006,19825
2000,MN,7,149830,108950,20266,279046,20266
2000,MN,8,138951,155924,22088,316963,22088
2000,MS,1,129269,81815,3229,214313,3229
2000,MS,2,69429,105046,3167,177642,3167
2000,MS,3,138975,68542,2240,209757,2240
2000,MS,4,107233,86201,3523,196957,3523
2000,MS,5,128343,63360,3953,195656,3953
2000,MO,1,39990,156288,4112,200390,4112
2000,MO,2,165499,130905,6839,303243,6839
2000,MO,3,118593,130055,7488,256136,7488
2000,MO,4,158990,107701,6360,273051,6360
2000,MO,5,84603,144769,6264,235636,6264
2000,MO,6,146972,123389,7556,277917,7556
2000,MO,7,173749,97734,7025,278508,7025
2000,MO,8,139318,92043,5359,236720,5359
2000,MO,9,162127,128189,7822,298138,7822
2000,MT,AL,240178,137126,33693,410997,33693
2000,NE,1,142161,86773,12491,241425,12491
2000,NE,2,131886,89148,10578,231612,10578
2000,NE,3,159815,55859,8310,223984,8310
2000,NV,1,99196,127686,8929,235811,8929
2000,NV,2,202379,152292,15173,369844,15173
2000,NH,1,142114,132760,13555,288429,13555
2000,NH,2,131445,133588,1433,266466,1433
2000,NJ,1,76130,147886,8437,232453,8437
2000,NJ,2,105536,135690,7760,248986,7760
2000,NJ,3,125056,153121,9545,287722,9545
2000,NJ,4,117407,138233,10116,265756,10116
2000,NJ,5,146995,126970,10040,284005,10040
2000,NJ,6,82854,125102,9705,217661,9705
2000,NJ,7,107721,136337,8400,252458,8400
2000,NJ,8,78688,132013,6759,217460,6759
2000,NJ,9,76488,143883,6344,226715,6344
2000,NJ,10,22210,136896,2772,161878,2772
2000,NJ,11,156378,126748,10279,293405,10279
2000,NJ,12,140494,155814,12483,308791,12483
2000,NJ,13,40517,116791,4230,161538,4230
2000,NM,1,101178,104705,8849,214732,8849
2000,NM,2,95241,75695,5513,176449,5513
2000,NM,3,89751,106284,9688,205723,9688
2000,NY,1,114126,140275,12980,267381,12980
2000,NY,2,89583,125111,9796,224490,9796
2000,NY,3,115123,152108,10153,277384,10153
2000,NY,4,94318,147864,9015,251197,9015
2000,NY,5,83305,148740,8643,240688,8643
2000,NY,6,18258,148658,2827,169743,2827
2000,NY,7,37255,104297,5107,146659,5107
2000,NY,8,37600,170136,14185,221921,14185
2000,NY,9,51696,120475,6417,178588,6417
2000,NY,10,11999,154372,5116,171487,5116
2000,NY,11,11607,140287,5360,157254,5360
2000,NY,12,16575,103110,8127,127812,8127
2000,NY,13,86342,103603,6634,196579,6634
2000,NY,14,55349,173003,14151,242503,14151
2000,NY,15,10136,150560,7003,167699,7003
2000,NY,16,7965,122663,1433,132061,1433
2000,NY,17,17404,138318,3984,159706,3984
2000,NY,18,81890,133423,7901,223214,7901
2000,NY,19,120101,131985,12458,264544,12458
2000,NY,20,112232,141973,10796,265001,10796
2000,NY,21,98185,151230,14926,264341,14926
2000,NY,22,140133,124194,16717,281044,16717
2000,NY,23,115796,102750,11661,230207,11661
2000,NY,24,103632,103959,10514,218105,10514
2000,NY,25,106027,132612,12508,251147,12508
2000,NY,26,101446,124913,17467,243826,17467
2000,NY,27,147221,117608,13811,278640,13811
2000,NY,28,105917,133723,11973,251613,11973
2000,NY,29,103954,126421,13175,243550,13175
2000,NY,30,85819,145317,13246,244382,13246
2000,NY,31,124681,99880,11290,235851,11290
2000,NC,1,85805,109118,790,195713,790
2000,NC,2,138757,110754,1559,251070,1559
2000,NC,3,119575,73727,1444,194746,1444
2000,NC,4,157574,168360,2766,328700,2766
2000,NC,5,152474,90983,1820,245277,1820
2000,NC,6,169110,92121,1942,263173,1942
2000,NC,7,121966,108920,1487,232373,1487
2000,NC,8,115927,88678,1466,206071,1466
2000,NC,9,158843,104232,1923,264998,1923
2000,NC,10,162795,79993,1912,244700,1912
2000,NC,11,158394,106829,4387,269610,4387
2000,NC,12,89945,123979,1269,215193,1269
2000,ND,AL,174852,95284,18131,288267,18131
2000,OH,1,104892,111593,7316,223801,7316
2000,OH,2,188081,91175,8188,287444,8188
2000,OH,3,108751,114028,6557,229336,6557
2000,OH,4,148804,83337,7920,240061,7920
2000,OH,5,143702,98012,8263,249977,8263
2000,OH,6,136818,99471,9123,245412,9123
2000,OH,7,146294,99227,7702,253223,7702
2000,OH,8,167464,89364,7633,264461,7633
2000,OH,9,98449,129236,7068,234753,7068
2000,OH,10,98558,121551,11451,231560,11451
2000,OH,11,31916,164919,6202,203037,6202
2000,OH,12,139666,127079,7959,274704,7959
2000,OH,13,139381,130106,10731,280218,10731
2000,OH,14,100397,128790,9640,238827,9640
2000,OH,15,128190,111171,6581,245942,6581
2000,OH,16,129707,101890,9832,241429,9832
2000,OH,17,91618,140935,9751,242304,9751
2000,OH,18,122470,107802,10906,241178,10906
2000,OH,19,126051,136145,10745,272941,10745
2000,OK,1,140301,84583,2984,227868,2984
2000,OK,2,111770,97609,3441,212820,3441
2000,OK,3,110667,83545,2463,196675,2463
2000,OK,4,119496,73224,2169,194889,2169
2000,OK,5,151538,68199,2568,222305,2568
2000,OK,6,110166,66922,1982,179070,1982
2000,OR,1,144545,168358,18671,331574,18671
2000,OR,2,186788,108211,18320,313319,18320
2000,OR,3,87936,173019,21854,282809,21854
2000,OR,4,145738,129795,20368,295901,20368
2000,OR,5,148570,140959,17417,306946,17417
2000,PA,1,24389,156598,3209,184196,3209
2000,PA,2,22291,185537,3748,211576,3748
2000,PA,3,63562,133966,5117,202645,5117
2000,PA,4,125648,117458,6276,249382,6276
2000,PA,5,122604,79664,7374,209642,7374
2000,PA,6,114910,95024,7804,217738,7804
2000,PA,7,131087,138550,8214,277851,8214
2000,PA,8,128022,138605,8885,275512,8885
2000,PA,9,138938,69050,5078,213066,5078
2000,PA,10,122345,114303,9119,245767,9119
2000,PA,11,98903,104503,8793,212199,8793
2000,PA,12,110436,94782,6022,211240,6022
2000,PA,13,123049,155042,7377,285468,7377
2000,PA,14,79993,143004,7574,230571,7574
2000,PA,15,109495,114676,8756,232927,8756
2000,PA,16,148175,97689,6833,252697,6833
2000,PA,17,144956,89402,6387,240745,6387
2000,PA,18,101324,141096,7186,249606,7186
2000,PA,19,147828,85775,7114,240717,7114
2000,PA,20,110688,120895,6284,237867,6284
2000,PA,21,112340,110246,7924,230510,7924
2000,RI,1,60441,121686,12953,195080,12953
2000,RI,2,69743,125429,14694,209866,14694
2000,SC,1,144012,92275,6791,243078,6791
2000,SC,2,159089,108762,6870,274721,6870
2000,SC,3,140769,77467,5139,223375,5139
2000,SC,4,152575,78802,5863,237240,5863
2000,SC,5,119817,89334,3903,213054,3903
2000,SC,6,70619,119393,2545,192557,2545
2000,SD,AL,190700,118804,6765,316269,6765
2000,TN,1,131954,80431,3168,215553,3168
2000,TN,2,145009,94298,4095,243402,4095
2000,TN,3,122646,99641,3645,225932,3645
2000,TN,4,115897,101045,2997,219939,2997
2000,TN,5,90235,127867,3939,222041,3939
2000,TN,6,152420,127606,4303,284329,4303
2000,TN,7,154685,109803,3149,267637,3149
2000,TN,8,104490,103787,2376,210653,2376
2000,TN,9,44613,137243,2269,184125,2269
2000,TX,1,137335,77186,2551,217072,2551
2000,TX,2,133772,81553,3402,218727,3402
2000,TX,3,185390,80293,7011,272694,7011
2000,TX,4,174983,68192,3852,247027,3852
2000,TX,5,106758,77805,4987,189550,4987
2000,TX,6,206470,84493,6819,297782,6819
2000,TX,7,185186,69151,7492,261829,7492
2000,TX,8,220983,63869,5627,290479,5627
2000,TX,9,120872,99116,4825,224813,4825
2000,TX,10,132690,122919,33728,289337,33728
2000,TX,11,127348,64554,3419,195321,3419
2000,TX,12,110472,75366,4254,190092,4254
2000,TX,13,120503,54473,3526,178502,3526
2000,TX,14,147328,80100,7572,235000,7572
2000,TX,15,72316,87126,2186,161628,2186
2000,TX,16,54051,79542,3446,137039,3446
2000,TX,17,147621,59187,3399,210207,3399
2000,TX,18,45818,123707,5871,175396,5871
2000,TX,19,162657,39870,3415,205942,3415
2000,TX,20,63632,81714,4707,150053,4707
2000,TX,21,247819,82045,11216,341080,11216
2000,TX,22,163375,93648,6304,263327,6304
2000,TX,23,116458,85085,4544,206087,4544
2000,TX,24,80412,86072,2731,169215,2731
2000,TX,25,85064,88661,5420,179145,5420
2000,TX,26,213622,81206,8473,303301,8473
2000,TX,27,80089,81034,3189,164312,3189
2000,TX,28,69309,93121,2919,165349,2919
2000,TX,29,45190,70412,1994,117596,1994
2000,TX,30,41673,101911,2009,145593,2009
2000,UT,1,193635,59858,14187,267680,14187
2000,UT,2,148244,88077,24425,260746,24425
2000,UT,3,173217,55118,13645,241980,13645
2000,VT,AL,119775,149022,25511,294308,25511
2000,VA,1,161116,109084,7405,277605,7405
2000,VA,2,99979,84344,4511,188834,4511
2000,VA,3,57002,117113,4658,178773,4658
2000,VA,4,116861,116388,3837,237086,3837
2000,VA,5,134391,96097,8328,238816,8328
2000,VA,6,135417,89524,6915,231856,6915
2000,VA,7,194807,109312,8533,312652,8533
2000,VA,8,109034,149591,11615,270240,11615
2000,VA,9,116851,90916,6548,214315,6548
2000,VA,10,191443,128515,10004,329962,10004
2000,VA,11,120589,126406,9506,256501,9506
2000,WA,1,123804,159462,14058,297324,14058
2000,WA,2,140437,146456,17578,304471,17578
2000,WA,3,139179,136691,16500,292370,16500
2000,WA,4,147675,80316,8940,236931,8940
2000,WA,5,142185,103116,12051,257352,12051
2000,WA,6,113753,133491,14122,261366,14122
2000,WA,7,58480,210797,22119,291396,22119
2000,WA,8,145410,152597,12537,310544,12537
2000,WA,9,97941,124726,10318,232985,10318
2000,WV,1,121267,96340,7323,224930,7323
2000,WV,2,124756,101675,5198,231629,5198
2000,WV,3,90450,97482,3783,191715,3783
2000,WI,1,131456,136146,10405,278007,10405
2000,WI,2,118311,188419,18001,324731,18001
2000,WI,3,131692,140163,15494,287349,15494
2000,WI,4,139680,126687,10652,277019,10652
2000,WI,5,72972,153447,8857,235276,8857
2000,WI,6,150127,122374,12134,284635,12134
2000,WI,7,130173,134035,15802,280010,15802
2000,WI,8,152700,129152,12524,294376,12524
2000,WI,9,210165,112561,11174,333900,11174
2000,WY,AL,147947,60481,9923,218351,9923
2004,AL,1,168117,91832,1934,261883,1934
2004,AL,2,170427,84043,1314,255784,1314
2004,AL,3,146380,103456,1618,251454,1618
2004,AL,4,186509,73504,1972,261985,1972
2004,AL,5,167552,110633,2389,280574,2389
2004,AL,6,248095,69449,2217,319761,2217
2004,AL,7,88433,160875,1086,250394,1086
2004,AK,AL,190889,111025,10684,312598,10684
2004,AZ,1,139221,117673,2132,259026,2132
2004,AZ,2,182326,112620,1741,296687,1741
2004,AZ,3,150511,107881,1612,260004,1612
2004,AZ,4,43967,71805,930,116702,930
2004,AZ,5,152576,127811,1620,282007,1620
2004,AZ,6,188372,102902,1459,292733,1459
2004,AZ,7,79674,105532,1242,186448,1242
2004,AZ,8,167647,147300,2014,316961,2014
2004,AR,1,127179,115994,3020,246193,3020
2004,AR,2,145392,134478,2785,282655,2785
2004,AR,3,171853,100656,3449,275958,3449
2004,AR,4,128474,118825,2840,250139,2840
2004,CA,1,111754,173926,6324,292004,6324
2004,CA,2,173528,102254,4272,280054,4272
2004,CA,3,176512,123671,3017,303200,3017
2004,CA,4,216838,132267,4758,353863,4758
2004,CA,5,77788,125378,2172,205338,2172
2004,CA,6,90432,226051,4980,321463,4980
2004,CA,7,72994,153988,2300,229282,2300
2004,CA,8,40558,244009,4024,288591,4024
2004,CA,9,33450,228642,4082,266174,4082
2004,CA,10,117037,169373,3098,289508,3098
2004,CA,11,151397,127102,2306,280805,2306
2004,CA,12,73740,193689,2646,270075,2646
2004,CA,13,60559,153598,2378,216535,2378
2004,CA,14,83326,188864,3981,276171,3981
2004,CA,15,82742,145007,2903,230652,2903
2004,CA,16,70190,125415,2089,197694,2089
2004,CA,17,75005,149029,3253,227287,3253
2004,CA,18,80157,79764,1692,161613,1692
2004,CA,19,151603,93918,2375,247896,2375
2004,CA,20,56045,58534,1040,115619,1040
2004,CA,21,133004,68501,1767,203272,1767
2004,CA,22,180584,82356,2747,265687,2747
2004,CA,23,101817,147361,3464,252642,3464
2004,CA,24,165430,127875,3473,296778,3473
2004,CA,25,142052,96355,3081,241488,3081
2004,CA,26,148352,117532,3202,269086,3202
2004,CA,27,86397,130567,3034,219998,3034
2004,CA,28,49220,125351,2011,176582,2011
2004,CA,29,83448,136796,3097,223341,3097
2004,CA,30,109014,220181,3660,332855,3660
2004,CA,31,26054,92894,1815,120763,1815
2004,CA,32,58341,99286,1756,159383,1756
2004,CA,33,33132,172382,2631,208145,2631
2004,CA,34,35926,82942,1654,120522,1654
2004,CA,35,33110,130764,1726,165600,1726
2004,CA,36,103425,154010,3558,260993,3558
2004,CA,37,43160,126068,2281,171509,2281
2004,CA,38,54869,106652,1846,163367,1846
2004,CA,39,70635,102660,2110,175405,2110
2004,CA,40,138766,88631,2740,230137,2740
2004,CA,41,149673,89424,2729,241826,2729
2004,CA,42,164998,98108,2578,265684,2578
2004,CA,43,55952,79946,1497,137395,1497
2004,CA,44,139476,94374,2562,236412,2562
2004,CA,45,132288,101679,2102,236069,2102
2004,CA,46,168158,122991,3734,294883,3734
2004,CA,47,56226,54623,1393,112242,1393
2004,CA,48,178739,123664,3364,305767,3364
2004,CA,49,149283,86998,2389,238670,2389
2004,CA,50,169935,135007,2891,307833,2891
2004,CA,51,85762,100062,1731,187555,1731
2004,CA,52,177055,108806,2509,288370,2509
2004,CA,53,89890,146160,2953,239003,2953
2004,CO,1,81265,180064,2817,264146,2817
2004,CO,2,132642,188538,1975,323155,1975
2004,CO,3,171115,135755,3787,310657,3787
2004,CO,4,180017,128002,2637,310656,2637
2004,CO,5,190190,93684,3248,287122,3248
2004,CO,6,223156,144683,2553,370392,2553
2004,CO,7,122772,130984,1150,254906,1150
2004,CT,1,121263,187089,5814,314166,5814
2004,CT,2,147819,180235,6214,334268,6214
2004,CT,3,128960,174382,5981,309323,5981
2004,CT,4,143280,162166,4121,309567,4121
2004,CT,5,152504,153616,5325,311445,5325
2004,DE,AL,171660,200152,3458,375270,3458
2004,DC,AL,21256,202970,3360,227586,3360
2004,FL,1,231199,88686,2135,322020,2135
2004,FL,2,181300,153164,1346,335810,1346
2004,FL,3,81778,151466,42,233286,42
2004,FL,4,227431,100414,744,328589,744
2004,FL,5,221259,156632,1948,379839,1948
2004,FL,6,210101,136622,838,347561,838
2004,FL,7,204454,155302,964,360720,964
2004,FL,8,160722,133328,261,294311,261
2004,FL,9,196837,148694,953,346484,953
2004,FL,10,158082,150761,0,308843,0
2004,FL,11,103748,145831,1764,251343,1764
2004,FL,12,167216,119825,798,287839,798
2004,FL,13,200932,156727,2642,360301,2642
2004,FL,14,222234,136049,2631,360914,2631
2004,FL,15,195076,146914,2128,344118,2128
2004,FL,16,183339,154632,1312,339283,1312
2004,FL,17,35642,178605,0,214247,0
2004,FL,18,127746,107073,0,234819,0
2004,FL,19,107348,210695,0,318043,0
2004,FL,20,104039,183510,0,287549,0
2004,FL,21,127326,96232,0,223558,0
2004,FL,22,153265,169161,0,322426,0
2004,FL,23,50138,155915,28,206081,28
2004,FL,24,188973,153130,476,342579,476
2004,FL,25,122342,95001,0,217343,0
2004,GA,1,158216,72658,1136,232010,1136
2004,GA,2,108128,92769,955,201852,955
2004,GA,3,125362,99930,1184,226476,1184
2004,GA,4,70600,183190,1829,255619,1829
2004,GA,5,65488,176332,2121,243941,2121
2004,GA,6,229990,96456,2627,329073,2627
2004,GA,7,225342,72100,2174,299616,2174
2004,GA,8,231269,83292,1606,316167,1606
2004,GA,9,200604,75971,1763,278338,1763
2004,GA,10,197988,58876,1783,258647,1783
2004,GA,11,121610,97105,1223,219938,1223
2004,GA,12,103295,120563,1588,225446,1588
2004,GA,13,76327,136912,1089,214328,1089
2004,HI,1,99305,110916,1247,211468,1247
2004,HI,2,94886,120790,1867,217543,1867
2004,ID,1,215069,94915,4446,314430,4446
2004,ID,2,194166,86183,3668,284017,3668
2004,IL,1,47533,234086,565,282184,565
2004,IL,2,43822,230613,353,274788,353
2004,IL,3,100257,144657,533,245447,533
2004,IL,4,27684,105419,809,133912,809
2004,IL,5,79349,161348,1539,242236,1539
2004,IL,6,139028,121344,0,260372,0
2004,IL,7,45071,227018,887,272976,887
2004,IL,8,153245,121710,0,274955,0
2004,IL,9,81138,175288,677,257103,677
2004,IL,10,134536,150267,0,284803,0
2004,IL,11,162779,140619,1018,304416,1018
2004,IL,12,139710,152055,1600,293365,1600
2004,IL,13,175705,142397,0,318102,0
2004,IL,14,158428,125269,1828,285525,1828
2004,IL,15,174928,121814,2227,298969,2227
2004,IL,16,168303,133701,1539,303543,1539
2004,IL,17,139251,148562,1333,289146,1333
2004,IL,18,181058,130669,1954,313681,1954
2004,IL,19,192678,123172,1287,317137,1287
2004,IN,1,118417,148698,2214,269329,2214
2004,IN,2,146000,112671,1964,260635,1964
2004,IN,3,172919,79674,737,253330,737
2004,IN,4,196010,85179,1700,282889,1700
2004,IN,5,233215,91955,1506,326676,1506
2004,IN,6,177214,97781,2096,277091,2096
2004,IN,7,93347,130779,0,224126,0
2004,IN,8,170390,104625,2006,277021,2006
2004,IN,9,171926,117647,1568,291141,1568
2004,IA,1,138073,157380,2381,297834,2381
2004,IA,2,135991,171561,3090,310642,3090
2004,IA,3,154919,154652,2443,312014,2443
2004,IA,4,155587,148331,2711,306629,2711
2004,IA,5,167387,109974,2428,279789,2428
2004,KS,1,199554,73309,3962,276825,3962
2004,KS,2,176764,117924,4103,298791,4103
2004,KS,3,186476,150598,3262,340336,3262
2004,KS,4,173643,93129,3783,270555,3783
2004,KY,1,180446,102346,1866,284658,1866
2004,KY,2,190612,100580,2065,293257,2065
2004,KY,3,160772,167440,0,328212,0
2004,KY,4,195055,111049,2547,308651,2547
2004,KY,5,159489,102142,1911,263542,1911
2004,KY,6,182787,128967,2505,314259,2505
2004,LA,1,215538,87009,3076,305623,3076
2004,LA,2,58855,183928,1858,244641,1858
2004,LA,3,162269,115011,3826,281106,3826
2004,LA,4,156298,105962,2771,265031,2771
2004,LA,5,168484,100511,3410,272405,3410
2004,LA,6,172080,117255,2524,291859,2524
2004,LA,7,168645,110623,3103,282371,3103
2004,ME,1,165824,211703,6865,384392,6865
2004,ME,2,164377,185139,6844,356360,6844
2004,MD,1,213144,124163,3828,341135,3828
2004,MD,2,118429,144090,3103,265622,3103
2004,MD,3,136672,163088,3873,303633,3873
2004,MD,4,58170,217549,1843,277562,1843
2004,MD,5,128861,177035,2692,308588,2692
2004,MD,6,209764,110821,3635,324220,3635
2004,MD,7,69545,192081,2830,264456,2830
2004,MD,8,90108,205660,3196,298964,3196
2004,MA,1,103990,185377,4352,293719,4352
2004,MA,2,113284,169460,3324,286068,3324
2004,MA,3,112957,167402,3667,284026,3667
2004,MA,4,99878,194914,3502,298294,3502
2004,MA,5,114874,158455,3813,277142,3813
2004,MA,6,130924,185264,3970,320158,3970
2004,MA,7,96374,192133,3880,292387,3880
2004,MA,8,40885,168264,3683,212832,3683
2004,MA,9,106734,188439,3378,298551,3378
2004,MA,10,151209,194092,3910,349211,3910
2004,MI,1,177315,151450,3785,332550,3785
2004,MI,2,203051,131552,3180,337783,3180
2004,MI,3,197493,133460,3292,334245,3292
2004,MI,4,181314,145774,3425,330513,3425
2004,MI,5,129457,187671,2532,319660,2532
2004,MI,6,164595,143906,3115,311616,3115
2004,MI,7,176624,145979,3458,326061,3458
2004,MI,8,191287,161282,3645,356214,3645
2004,MI,9,180073,174078,3272,357423,3272
2004,MI,10,193727,147288,3477,344492,3477
2004,MI,11,183835,164037,4097,351969,4097
2004,MI,12,125460,193894,3239,322593,3239
2004,MI,13,45019,188555,1504,235078,1504
2004,MI,14,46240,219075,1667,266982,1667
2004,MI,15,118217,191091,3156,312464,3156
2004,MN,1,171952,159776,5043,336771,5043
2004,MN,2,203538,169704,4105,377347,4105
2004,MN,3,190339,179488,3736,373563,3736
2004,MN,4,123313,205467,4341,333121,4341
2004,MN,5,92797,237418,5064,335279,5064
2004,MN,6,216574,161601,4576,382751,4576
2004,MN,7,180743,140332,4917,325992,4917
2004,MN,8,167439,191228,4896,363563,4896
2004,MS,1,187979,111837,2211,302027,2211
2004,MS,2,104749,153786,2846,261381,2846
2004,MS,3,203373,106461,2292,312126,2292
2004,MS,4,188880,86010,1941,276831,1941
2004,MO,1,71367,216372,0,287739,0
2004,MO,2,215123,142824,155,358102,155
2004,MO,3,127668,168740,657,297065,657
2004,MO,4,187111,102652,1622,291385,1622
2004,MO,5,118915,175352,714,294981,714
2004,MO,6,178669,132007,2001,312677,2001
2004,MO,7,202486,97557,1705,301748,1705
2004,MO,8,173378,97778,1886,273042,1886
2004,MO,9,180362,124965,2008,307335,2008
2004,MT,AL,266063,173710,10672,450445,10672
2004,NE,1,169888,96314,3896,270098,3896
2004,NE,2,153041,97858,3525,254424,3525
2004,NE,3,189885,60156,3623,253664,3623
2004,NV,1,89800,121453,3457,214710,3457
2004,NV,2,172422,123490,5641,301553,5641
2004,NV,3,156335,152150,4608,313093,4608
2004,NH,1,171013,163191,2803,337007,2803
2004,NH,2,160224,177320,3187,340731,3187
2004,NJ,1,111073,170786,0,281859,0
2004,NJ,2,141123,138797,2578,282498,2578
2004,NJ,3,167254,159041,0,326295,0
2004,NJ,4,172369,134220,0,306589,0
2004,NJ,5,184530,137019,622,322171,622
2004,NJ,6,109729,144105,0,253834,0
2004,NJ,7,164176,144767,0,308943,0
2004,NJ,8,99239,142081,0,241320,0
2004,NJ,9,101229,144723,0,245952,0
2004,NJ,10,36660,167707,0,204367,0
2004,NJ,11,186993,135578,1847,324418,1847
2004,NJ,12,138454,165776,0,304230,0
2004,NJ,13,57278,127168,0,184446,0
2004,NM,1,131140,140106,3339,274585,3339
2004,NM,2,127393,91073,2285,220751,2285
2004,NM,3,118397,139763,2808,260968,2808
2004,NY,1,154249,152165,6096,312510,6096
2004,NY,2,127626,148625,5660,281911,5660
2004,NY,3,162181,147317,4355,313853,4355
2004,NY,4,124617,153546,3215,281378,3215
2004,NY,5,74635,128252,1909,204796,1909
2004,NY,6,27352,154468,1257,183077,1257
2004,NY,7,44607,129909,1499,176015,1499
2004,NY,8,66948,180080,2892,249920,2892
2004,NY,9,87449,111850,1796,201095,1796
2004,NY,10,25359,166840,1280,193479,1280
2004,NY,11,26172,172654,1741,200567,1741
2004,NY,12,29942,130019,1867,161828,1867
2004,NY,13,118370,96474,1945,216789,1945
2004,NY,14,66494,201782,3369,271645,3369
2004,NY,15,20049,194186,2430,216665,2430
2004,NY,16,14766,130109,856,145731,856
2004,NY,17,73896,149727,3163,226786,3163
2004,NY,18,119981,164342,4382,288705,4382
2004,NY,19,162981,137449,4606,305036,4606
2004,NY,20,170323,145296,6824,322443,6824
2004,NY,21,133016,169693,6553,309262,6553
2004,NY,22,127248,151898,6468,285614,6468
2004,NY,23,134174,123216,5545,262935,5545
2004,NY,24,147510,130573,6385,284468,6385
2004,NY,25,150097,158058,6081,314236,6081
2004,NY,26,176235,137543,5691,319469,5691
2004,NY,27,132416,158433,6833,297682,6833
2004,NY,28,92627,162319,5557,260503,5557
2004,NY,29,171317,127481,5470,304268,5470
2004,NC,1,94738,128129,554,223421,554
2004,NC,2,128220,107912,777,236909,777
2004,NC,3,169674,79936,839,250449,839
2004,NC,4,154743,193126,1833,349702,1833
2004,NC,5,191034,95811,1140,287985,1140
2004,NC,6,200942,87295,1202,289439,1202
2004,NC,7,141459,110589,858,252906,858
2004,NC,8,126041,105248,815,232104,815
2004,NC,9,193419,110769,1134,305322,1134
2004,NC,10,169484,82965,1043,253492,1043
2004,NC,11,169872,126979,1747,298598,1747
2004,NC,12,88955,149940,871,239766,871
2004,NC,13,132581,147144,1180,280905,1180
2004,ND,AL,196651,111052,5130,312833,5130
2004,OH,1,152441,149180,1157,302778,1157
2004,OH,2,211489,119139,1228,331856,1228
2004,OH,3,178323,148978,1227,328528,1227
2004,OH,4,193875,102332,1452,297659,1452
2004,OH,5,188935,119308,1695,309938,1695
2004,OH,6,153983,149080,1628,304691,1628
2004,OH,7,176365,132124,1548,310037,1548
2004,OH,8,199265,109374,1338,309977,1338
2004,OH,9,129825,181889,791,312505,791
2004,OH,10,125102,175149,1364,301615,1364
2004,OH,11,52372,237469,1942,291783,1942
2004,OH,12,178080,171881,1366,351327,1366
2004,OH,13,140908,177472,1311,319691,1311
2004,OH,14,178510,159929,1612,340051,1612
2004,OH,15,154105,151869,1447,307421,1447
2004,OH,16,171561,146066,1547,319174,1547
2004,OH,17,111663,188531,1564,301758,1564
2004,OH,18,163121,121495,1873,286489,1873
2004,OK,1,206744,109486,0,316230,0
2004,OK,2,166826,114113,0,280939,0
2004,OK,3,209598,82670,0,292268,0
2004,OK,4,194977,96100,0,291077,0
2004,OK,5,181644,101595,0,283239,0
2004,OR,1,161738,200489,4507,366734,4507
2004,OR,2,218288,135560,4895,358743,4895
2004,OR,3,118442,242075,568,361085,568
2004,OR,4,187292,188479,5801,381572,5801
2004,OR,5,181070,176558,4058,361686,4058
2004,PA,1,41509,227327,531,269367,531
2004,PA,2,37811,266174,759,304744,759
2004,PA,3,152473,133764,861,287098,861
2004,PA,4,179855,149070,1255,330180,1255
2004,PA,5,165343,105295,1031,271669,1031
2004,PA,6,156634,167431,1064,325129,1064
2004,PA,7,163095,184392,233,347720,233
2004,PA,8,165239,177008,1997,344244,1997
2004,PA,9,183717,89208,646,273571,646
2004,PA,10,170880,112923,1196,284999,1196
2004,PA,11,127866,143205,843,271914,843
2004,PA,12,133088,141046,119,274253,119
2004,PA,13,140900,182552,1345,324797,1345
2004,PA,14,88316,205636,2325,296277,2325
2004,PA,15,150213,150939,1404,302556,1404
2004,PA,16,182856,113193,1472,297521,1472
2004,PA,17,172343,124141,1768,298252,1768
2004,PA,18,183210,154079,1275,338564,1275
2004,PA,19,198192,110274,1515,309981,1515
2004,RI,1,77480,131245,3914,212639,3914
2004,RI,2,91566,128515,4350,224431,4350
2004,SC,1,172836,109790,4263,286889,4263
2004,SC,2,174340,114253,2468,291061,2468
2004,SC,3,169283,86947,2548,258778,2548
2004,SC,4,181255,94760,3241,279256,3241
2004,SC,5,143001,104850,2587,250438,2587
2004,SC,6,97248,151061,2069,250378,2069
2004,SD,AL,232584,149244,6387,388215,6387
2004,TN,1,172079,79507,1800,253386,1800
2004,TN,2,185450,100032,2377,287859,2377
2004,TN,3,163612,102390,2063,268065,2063
2004,TN,4,154457,109802,1935,266194,1935
2004,TN,5,129455,140874,1994,272323,1994
2004,TN,6,167372,111203,1721,280296,1721
2004,TN,7,206410,104792,2216,313418,2216
2004,TN,8,131524,116327,1423,249274,1423
2004,TN,9,74020,171547,899,246466,899
2004,TX,1,178409,78609,0,257018,0
2004,TX,2,160365,92842,0,253207,0
2004,TX,3,174711,86718,0,261429,0
2004,TX,4,192926,81269,0,274195,0
2004,TX,5,160240,77952,0,238192,0
2004,TX,6,173476,87454,0,260930,0
2004,TX,7,179456,99422,0,278878,0
2004,TX,8,194696,73946,0,268642,0
2004,TX,9,48052,112065,0,160117,0
2004,TX,10,177555,109287,0,286842,0
2004,TX,11,188929,52174,0,241103,0
2004,TX,12,162192,79862,0,242054,0
2004,TX,13,183375,52431,0,235806,0
2004,TX,14,169480,82792,0,252272,0
2004,TX,15,95086,77998,0,173084,0
2004,TX,16,71454,92792,0,164246,0
2004,TX,17,172355,74358,0,246713,0
2004,TX,18,48753,125155,0,173908,0
2004,TX,19,181516,52800,0,234316,0
2004,TX,20,78757,96539,0,175296,0
2004,TX,21,210121,137096,0,347217,0
2004,TX,22,177378,98180,0,275558,0
2004,TX,23,163389,89874,0,253263,0
2004,TX,24,161864,86786,0,248650,0
2004,TX,25,59814,101989,0,161803,0
2004,TX,26,181989,99633,0,281622,0
2004,TX,27,99087,81201,0,180288,0
2004,TX,28,97183,87811,0,184994,0
2004,TX,29,47734,59897,0,107631,0
2004,TX,30,45148,136116,0,181264,0
2004,TX,31,170234,85574,0,255808,0
2004,TX,32,120970,81846,0,202816,0
2004,UT,1,220869,75728,6824,303421,6824
2004,UT,2,227668,108286,8434,344388,8434
2004,UT,3,215205,57185,6689,279079,6689
2004,VT,AL,121180,184067,7062,312309,7062
2004,VA,1,188417,122771,2255,313443,2255
2004,VA,2,141097,101576,1896,244569,1896
2004,VA,3,79302,158561,1517,239380,1517
2004,VA,4,166689,125164,1713,293566,1713
2004,VA,5,158568,121960,3097,283625,3097
2004,VA,6,177133,100561,2883,280577,2883
2004,VA,7,204273,128166,2148,334587,2148
2004,VA,8,104298,189525,2782,296605,2782
2004,VA,9,153868,101662,3078,258608,3078
2004,VA,10,182210,145741,2736,330687,2736
2004,VA,11,161104,159055,2561,322720,2561
2004,WA,1,144740,193733,4968,343441,4968
2004,WA,2,156632,169420,6234,332286,6234
2004,WA,3,164709,158559,5418,328686,5418
2004,WA,4,160244,90026,3804,254074,3804
2004,WA,5,177375,127203,5709,310287,5709
2004,WA,6,137868,163131,5729,306728,5729
2004,WA,7,68600,283865,5836,358301,5836
2004,WA,8,168087,177229,4723,350039,4723
2004,WA,9,126625,147017,4197,277839,4197
2004,WV,1,150052,107904,2105,260061,2105
2004,WV,2,151019,112418,1779,265216,1779
2004,WV,3,122707,106219,1684,230610,1684
2004,WI,1,197970,170371,3252,371593,3252
2004,WI,2,151024,250151,4108,405283,4108
2004,WI,3,178367,192297,3942,374606,3942
2004,WI,4,94090,219636,2735,316461,2735
2004,WI,5,265537,151968,3641,421146,3641
2004,WI,6,208931,157212,3896,370039,3896
2004,WI,7,179963,185076,4141,369180,4141
2004,WI,8,202238,162793,3668,368699,3668
2004,WY,AL,167629,70776,5023,243428,5023
2008,AL,1,185579,116904,2135,304618,2135
2008,AL,2,182618,107669,1751,292038,1751
2008,AL,3,161154,124973,2468,288595,2468
2008,AL,4,205362,60207,3881,269450,3881
2008,AL,5,190225,117838,4221,312284,4221
2008,AL,6,268791,78150,3329,350270,3329
2008,AL,7,72801,207732,1151,281684,1151
2008,AK,AL,193841,123594,8762,326197,8762
2008,AZ,1,157160,127790,3848,288798,3848
2008,AZ,2,183414,114190,4279,301883,4279
2008,AZ,3,152829,116636,3422,272887,3422
2008,AZ,4,56694,92234,1651,150579,1651
2008,AZ,5,150067,137177,3362,290606,3362
2008,AZ,6,259863,164592,4068,428523,4068
2008,AZ,7,88313,120924,2491,211728,2491
2008,AZ,8,181771,161164,4141,347076,4141
2008,AR,1,145340,95102,7185,247627,7185
2008,AR,2,161540,131891,5855,299286,5855
2008,AR,3,185055,96485,6894,288434,6894
2008,AR,4,146082,98832,6356,251270,6356
2008,CA,1,96530,199835,7670,304035,7670
2008,CA,2,161636,125291,6618,293545,6618
2008,CA,3,164025,165617,6313,335955,6313
2008,CA,4,206385,167604,7493,381482,7493
2008,CA,5,67625,165776,4709,238110,4709
2008,CA,6,73345,253087,6613,333045,6613
2008,CA,7,66272,179037,4285,249594,4285
2008,CA,8,38665,266210,6449,311324,6449
2008,CA,9,29186,260662,5919,295767,5919
2008,CA,10,104628,204138,5604,314370,5604
2008,CA,11,139863,169183,5143,314189,5143
2008,CA,12,69029,214850,4898,288777,4898
2008,CA,13,56299,175838,4270,236407,4270
2008,CA,14,72707,213671,5883,292261,5883
2008,CA,15,75753,174571,4937,255261,4937
2008,CA,16,63975,154324,3585,221884,3585
2008,CA,17,61163,171180,4743,237086,4743
2008,CA,18,68629,104299,3075,176003,3075
2008,CA,19,141013,124533,4805,270351,4805
2008,CA,20,50146,77158,2180,129484,2180
2008,CA,21,125347,93578,3433,222358,3433
2008,CA,22,172792,110910,5400,289102,5400
2008,CA,23,85261,172348,5123,262732,5123
2008,CA,24,151678,160738,5650,318066,5650
2008,CA,25,131201,134222,5986,271409,5986
2008,CA,26,137329,149249,5885,292463,5885
2008,CA,27,75286,157100,5219,237605,5219
2008,CA,28,42815,147958,3492,194265,3492
2008,CA,29,71860,159947,4840,236647,4840
2008,CA,30,95869,242022,5710,343601,5710
2008,CA,31,25441,113941,3280,142662,3280
2008,CA,32,52356,119726,3557,175639,3557
2008,CA,33,27672,205470,3539,236681,3539
2008,CA,34,33056,106695,3023,142774,3023
2008,CA,35,27789,165761,2923,196473,2923
2008,CA,36,92105,176924,5754,274783,5754
2008,CA,37,36940,157219,3388,197547,3388
2008,CA,38,48599,130092,3846,182537,3846
2008,CA,39,63680,128579,4117,196376,4117
2008,CA,40,125066,114025,4763,243854,4763
2008,CA,41,147982,119255,5890,273127,5890
2008,CA,42,152256,128474,4996,285726,4996
2008,CA,43,49594,112020,3216,164830,3216
2008,CA,44,131003,133535,4973,269511,4973
2008,CA,45,129664,142305,4251,276220,4251
2008,CA,46,150937,145393,6239,302569,6239
2008,CA,47,48461,77144,2415,128020,2415
2008,CA,48,160584,163063,5959,329606,5959
2008,CA,49,137739,117283,4805,259827,4805
2008,CA,50,158845,172962,5616,337423,5616
2008,CA,51,76438,135960,3002,215400,3002
2008,CA,52,161332,135848,4827,302007,4827
2008,CA,53,77930,177863,5101,260894,5101
2008,CO,1,72573,222009,4637,299219,4637
2008,CO,2,125048,235165,6136,366349,6136
2008,CO,3,170852,162254,5648,338754,5648
2008,CO,4,171981,169113,6244,347338,6244
2008,CO,5,189498,129095,4992,323585,4992
2008,CO,6,229791,202122,5925,437838,5925
2008,CO,7,113848,168819,5615,288282,5615
2008,CT,1,108572,218794,4404,331770,4404
2008,CT,2,139945,204220,5056,349221,5056
2008,CT,3,117114,201741,3953,322808,3953
2008,CT,4,126819,190996,2130,319945,2130
2008,CT,5,136978,182021,4054,323053,4054
2008,DE,AL,152374,255459,4783,412616,4783
2008,DC,AL,17367,245800,2686,265853,2686
2008,FL,1,234185,112793,4349,351327,4349
2008,FL,2,199591,163954,4207,367752,4207
2008,FL,3,60062,169406,1636,231104,1636
2008,FL,4,233446,143324,3765,380535,3765
2008,FL,5,257083,199755,5770,462608,5770
2008,FL,6,228651,174701,4662,408014,4662
2008,FL,7,213831,183619,4516,401966,4516
2008,FL,8,168842,189402,2742,360986,2742
2008,FL,9,190367,169933,4597,364897,4597
2008,FL,10,151025,164255,4897,320177,4897
2008,FL,11,89793,178935,2691,271419,2691
2008,FL,12,168399,163745,3112,335256,3112
2008,FL,13,199216,178967,4525,382708,4525
2008,FL,14,226967,169067,3827,399861,3827
2008,FL,15,200229,186597,4638,391464,4638
2008,FL,16,192431,175017,4038,371486,4038
2008,FL,17,29764,209859,900,240523,900
2008,FL,18,123191,128763,1797,253751,1797
2008,FL,19,115740,223233,2253,341226,2253
2008,FL,20,106391,186974,2242,295607,2242
2008,FL,21,127412,122036,1232,250680,1232
2008,FL,22,162126,175889,2642,340657,2642
2008,FL,23,39578,194488,1152,235218,1152
2008,FL,24,197541,189895,3937,391373,3937
2008,FL,25,129940,127290,1382,258612,1382
2008,GA,1,167122,96818,2149,266089,2149
2008,GA,2,111559,130109,1322,242990,1322
2008,GA,3,235263,129895,3178,368336,3178
2008,GA,4,54868,208874,1974,265716,1974
2008,GA,5,63053,249297,2734,315084,2734
2008,GA,6,227701,133716,4301,365718,4301
2008,GA,7,212721,140009,3710,356440,3710
2008,GA,8,162376,123877,1978,288231,1978
2008,GA,9,225929,70366,3611,299906,3611
2008,GA,10,183441,113915,2773,300129,2773
2008,GA,11,204275,103112,3987,311374,3987
2008,GA,12,120150,143624,1733,265507,1733
2008,GA,13,80327,200567,2180,283074,2180
2008,HI,1,61116,152990,3103,217209,3103
2008,HI,2,59450,172881,4028,236359,4028
2008,ID,1,220787,128134,8210,357131,8210
2008,ID,2,183022,108693,7387,299102,7387
2008,IL,1,37472,251102,1587,290161,1587
2008,IL,2,28748,262750,1347,292845,1347
2008,IL,3,86406,158161,3203,247770,3203
2008,IL,4,19777,126399,1866,148042,1866
2008,IL,5,63733,181458,3383,248574,3383
2008,IL,6,115339,152127,3737,271203,3737
2008,IL,7,34481,260925,1935,297341,1935
2008,IL,8,130384,170333,4208,304925,4208
2008,IL,9,69081,189497,3202,261780,3202
2008,IL,10,114035,181071,2801,297907,2801
2008,IL,11,148600,175808,5080,329488,5080
2008,IL,12,131443,170391,4994,306828,4994
2008,IL,13,156695,191306,4148,352149,4148
2008,IL,14,145345,181329,4445,331119,4445
2008,IL,15,152222,143965,5264,301451,5264
2008,IL,16,145795,168503,5396,319694,5396
2008,IL,17,118163,160104,4031,282298,4031
2008,IL,18,156898,151687,5095,313680,5095
2008,IL,19,176342,142316,5615,324273,5615
2008,IN,1,111895,184871,2582,299348,2582
2008,IN,2,126801,153369,3347,283517,3347
2008,IN,3,162183,123571,2727,288481,2727
2008,IN,4,185847,142933,3557,332337,3557
2008,IN,5,218967,149745,3399,372111,3399
2008,IN,6,151605,133473,3933,289011,3933
2008,IN,7,76530,191381,2056,269967,2056
2008,IN,8,151570,140063,3727,295360,3727
2008,IN,9,160250,154633,3930,318813,3930
2008,IA,1,122629,175394,3138,301161,3138
2008,IA,2,122395,190973,3970,317338,3970
2008,IA,3,143771,173932,4239,321942,4239
2008,IA,4,142396,166104,4251,312751,4251
2008,IA,5,151188,122537,3166,276891,3166
2008,KS,1,184501,79638,4813,268952,4813
2008,KS,2,170635,134337,6013,310985,6013
2008,KS,3,177814,187372,5186,370372,5186
2008,KS,4,166705,113418,5440,285563,5440
2008,KY,1,176807,104626,4424,285857,4424
2008,KY,2,188955,118700,4473,312128,4473
2008,KY,3,150552,193260,3393,347205,3393
2008,KY,4,189008,118773,5086,312867,5086
2008,KY,5,162614,75815,4241,242670,4241
2008,KY,6,180526,140811,4444,325781,4444
2008,LA,1,221781,78325,4868,304974,4868
2008,LA,2,46205,137748,1873,185826,1873
2008,LA,3,167046,101428,5411,273885,5411
2008,LA,4,162198,108273,3152,273623,3152
2008,LA,5,177277,106097,3718,287092,3718
2008,LA,6,184422,132556,4297,321275,4297
2008,LA,7,188576,105117,4953,298646,4953
2008,ME,1,144604,232145,6877,383626,6877
2008,ME,2,150669,189778,7090,347537,7090
2008,MD,1,215918,147543,7136,370597,7136
2008,MD,2,113929,178241,5684,297854,5684
2008,MD,3,128593,192690,6523,327806,6523
2008,MD,4,45014,270377,2486,317877,2486
2008,MD,5,119020,233917,4520,357457,4520
2008,MD,6,200475,139744,7528,347747,7528
2008,MD,7,59183,234422,3929,297534,3929
2008,MD,8,77730,232533,4461,314724,4461
2008,MA,1,102645,196565,8271,307481,8271
2008,MA,2,117742,179466,7647,304855,7647
2008,MA,3,117862,175951,7019,300832,7019
2008,MA,4,107758,198079,6952,312789,6952
2008,MA,5,117877,176547,6117,300541,6117
2008,MA,6,136116,192995,7182,336293,7182
2008,MA,7,99062,193130,6840,299032,6840
2008,MA,8,33104,205113,4550,242767,4550
2008,MA,9,120394,188887,6243,315524,6243
2008,MA,10,156294,197365,7241,360900,7241
2008,MI,1,160131,166195,6543,332869,6543
2008,MI,2,179427,167607,5838,352872,5838
2008,MI,3,171255,169183,5999,346437,5999
2008,MI,4,163810,170277,5869,339956,5869
2008,MI,5,113020,207485,5257,325762,5257
2008,MI,6,144734,177314,5562,327610,5562
2008,MI,7,154653,172046,5905,332604,5905
2008,MI,8,172344,198205,6413,376962,6413
2008,MI,9,155279,202275,4984,362538,4984
2008,MI,10,179768,173920,6938,360626,6938
2008,MI,11,163958,197857,6115,367930,6115
2008,MI,12,108752,212850,5626,327228,5626
2008,MI,13,34231,200387,1933,236551,1933
2008,MI,14,36444,232473,2127,271044,2127
2008,MI,15,110833,224505,5861,341199,5861
2008,MN,1,158967,173884,8384,341235,8384
2008,MN,2,198960,193213,7681,399854,7681
2008,MN,3,175728,200240,6111,382079,6111
2008,MN,4,113600,217984,6835,338419,6835
2008,MN,5,81757,254796,7088,343641,7088
2008,MN,6,219936,183950,8519,412405,8519
2008,MN,7,162941,154140,8177,325258,8177
2008,MN,8,163520,195147,8811,367478,8811
2008,MS,1,217671,134066,3475,355212,3475
2008,MS,2,100211,196582,1708,298501,1708
2008,MS,3,209255,130793,2571,342619,2571
2008,MS,4,197460,93221,2852,293533,2852
2008,MO,1,59911,246451,2849,309211,2849
2008,MO,2,215175,172368,3839,391382,3839
2008,MO,3,124537,189730,4589,318856,4589
2008,MO,4,188312,117708,4813,310833,4813
2008,MO,5,111373,199405,3413,314191,3413
2008,MO,6,182692,152318,5955,340965,5955
2008,MO,7,207911,116666,5076,329653,5076
2008,MO,8,174564,102682,4688,281934,4688
2008,MO,9,181339,144583,5199,331121,5199
2008,MT,AL,243882,232159,16709,492750,16709
2008,NE,1,148179,121411,4303,273893,4303
2008,NE,2,135439,138809,3561,277809,3561
2008,NE,3,169361,73099,4282,246742,4282
2008,NV,1,85170,158357,5136,248663,5136
2008,NV,2,167904,167816,8417,344137,8417
2008,NV,3,159626,207475,7719,374820,7719
2008,NH,1,164403,186370,3026,353799,3026
2008,NH,2,152131,198456,3225,353812,3225
2008,NJ,1,103992,198196,3687,305875,3687
2008,NJ,2,137448,165983,3967,307398,3967
2008,NJ,3,162339,181004,3828,347171,3828
2008,NJ,4,169848,150975,3914,324737,3914
2008,NJ,5,179781,152506,3428,335715,3428
2008,NJ,6,98959,149400,2791,251150,2791
2008,NJ,7,165430,177471,4016,346917,4016
2008,NJ,8,93734,165346,2098,261178,2098
2008,NJ,9,99144,158933,2270,260347,2270
2008,NJ,10,30192,208151,1048,239391,1048
2008,NJ,11,182604,154300,3253,340157,3253
2008,NJ,12,139367,198145,3575,341087,3575
2008,NJ,13,50369,155012,1750,207131,1750
2008,NM,1,119342,180833,873,301048,873
2008,NM,2,118063,114928,3298,236289,3298
2008,NM,3,109427,176661,3456,289544,3456
2008,NY,1,153625,165975,3032,322632,3032
2008,NY,2,125978,164106,2272,292356,2272
2008,NY,3,164682,149995,2654,317331,2654
2008,NY,4,122166,171346,1945,295457,1945
2008,NY,5,73143,128276,1431,202850,1431
2008,NY,6,22302,185890,598,208790,598
2008,NY,7,38170,148242,943,187355,943
2008,NY,8,63769,184682,2121,250572,2121
2008,NY,9,88307,111237,1533,201077,1533
2008,NY,10,19677,205929,608,226214,608
2008,NY,11,20709,206656,999,228364,999
2008,NY,12,23504,154394,1283,179181,1283
2008,NY,13,112491,108439,1558,222488,1558
2008,NY,14,56946,212802,2402,272150,2402
2008,NY,15,14954,226049,1522,242525,1522
2008,NY,16,8437,158671,335,167443,335
2008,NY,17,66027,172479,1312,239818,1312
2008,NY,18,112214,184182,2294,298690,2294
2008,NY,19,153424,160645,3100,317169,3100
2008,NY,20,157879,167827,5286,330992,5286
2008,NY,21,123378,179322,5733,308433,5733
2008,NY,22,111896,168598,4168,284662,4168
2008,NY,23,119943,133367,4112,257422,4112
2008,NY,24,133277,139832,4743,277852,4743
2008,NY,25,135931,177780,5216,318927,5216
2008,NY,26,166890,148588,4570,320048,4570
2008,NY,27,127249,156635,5144,289028,5144
2008,NY,28,81445,184132,3332,268909,3332
2008,NY,29,153432,146698,3966,304096,3966
2008,NC,1,105738,177941,1288,284967,1288
2008,NC,2,141840,155681,2397,299918,2397
2008,NC,3,190093,117178,2456,309727,2456
2008,NC,4,159427,275205,4305,438937,4305
2008,NC,5,203076,126556,4208,333840,4208
2008,NC,6,212011,122291,3525,337827,3525
2008,NC,7,167888,150071,2747,320706,2747
2008,NC,8,135234,152261,2222,289717,2222
2008,NC,9,212250,174410,3043,389703,3043
2008,NC,10,191580,108496,3501,303577,3501
2008,NC,11,179061,159772,4746,343579,4746
2008,NC,12,89790,218599,2033,310422,2033
2008,NC,13,140486,204190,3193,347869,3193
2008,ND,AL,168887,141403,7448,317738,7448
2008,OH,1,134682,165816,3177,303675,3177
2008,OH,2,201494,137736,4662,343892,4662
2008,OH,3,170174,156699,4858,331731,4858
2008,OH,4,180233,114981,6012,301226,6012
2008,OH,5,166215,141039,6271,313525,6271
2008,OH,6,150865,142850,6313,300028,6313
2008,OH,7,172627,143712,5238,321577,5238
2008,OH,8,191065,119889,5538,316492,5538
2008,OH,9,113615,195399,4963,313977,4963
2008,OH,10,115025,174598,4289,293912,4289
2008,OH,11,41601,245342,1899,288842,1899
2008,OH,12,171044,209516,4773,385333,4773
2008,OH,13,138197,186811,4546,329554,4546
2008,OH,14,169416,168838,5140,343394,5140
2008,OH,15,149890,173311,5685,328886,5685
2008,OH,16,161070,152721,6368,320159,6368
2008,OH,17,106137,182740,6084,294961,6084
2008,OH,18,150470,128046,6864,285380,6864
2008,OK,1,205329,114446,0,319775,0
2008,OK,2,174351,91481,0,265832,0
2008,OK,3,210104,78434,0,288538,0
2008,OK,4,200192,101418,0,301610,0
2008,OK,5,170189,116717,0,286906,0
2008,OR,1,135975,228817,10086,374878,10086
2008,OR,2,193002,154848,10473,358323,10473
2008,OR,3,93931,260128,10144,364203,10144
2008,OR,4,161079,201143,11698,373920,11698
2008,OR,5,154488,192355,9697,356540,9697
2008,PA,1,34276,256940,1364,292580,1364
2008,PA,2,31584,298834,1435,331853,1435
2008,PA,3,143433,143416,4066,290915,4066
2008,PA,4,185239,149851,3407,338497,3407
2008,PA,5,152946,123503,3944,280393,3944
2008,PA,6,148231,207911,3516,359658,3516
2008,PA,7,157367,203407,3502,364276,3502
2008,PA,8,160695,192570,3905,357170,3905
2008,PA,9,176023,98430,3368,277821,3368
2008,PA,10,155864,131345,3600,290809,3600
2008,PA,11,121559,164451,3229,289239,3229
2008,PA,12,133414,132580,3915,269909,3915
2008,PA,13,132249,191180,3057,326486,3057
2008,PA,14,87296,210507,2946,300749,2946
2008,PA,15,139396,179589,4158,323143,4158
2008,PA,16,161844,150341,2719,314904,2719
2008,PA,17,158841,148104,3881,310826,3881
2008,PA,18,187771,151006,3271,342048,3271
2008,PA,19,187857,142398,3698,333953,3698
2008,RI,1,75807,148302,3701,227810,3701
2008,RI,2,89584,148269,4104,241957,4104
2008,SC,1,196389,146919,4298,347606,4298
2008,SC,2,189949,159063,3567,352579,3567
2008,SC,3,188316,103434,3803,295553,3803
2008,SC,4,190113,119259,5254,314626,5254
2008,SC,5,167072,144267,3635,314974,3635
2008,SC,6,103057,189507,2829,295393,2829
2008,SD,AL,203054,170924,7997,381975,7997
2008,TN,1,182499,75255,3836,261590,3836
2008,TN,2,195146,104166,4586,303898,4586
2008,TN,3,174372,103878,3603,281853,3603
2008,TN,4,173892,92964,4581,271437,4581
2008,TN,5,127795,166231,3620,297646,3620
2008,TN,6,190364,112575,4739,307678,4739
2008,TN,7,229068,121272,3374,353714,3374
2008,TN,8,148050,112943,3338,264331,3338
2008,TN,9,57993,198153,1456,257602,1456
2008,TX,1,184560,81749,1436,267745,1436
2008,TX,2,159165,105745,1484,266394,1484
2008,TX,3,171119,124027,2032,297178,2032
2008,TX,4,213968,93439,2259,309666,2259
2008,TX,5,158356,90135,1548,250039,1548
2008,TX,6,172061,114133,1863,288057,1863
2008,TX,7,173162,121472,2082,296716,2082
2008,TX,8,215846,74695,2065,292606,2065
2008,TX,9,40240,137619,684,178543,684
2008,TX,10,187503,150716,2941,341160,2941
2008,TX,11,185389,58326,1919,245634,1919
2008,TX,12,171408,99083,2009,272500,2009
2008,TX,13,181541,53860,1786,237187,1786
2008,TX,14,177370,88532,1761,267663,1761
2008,TX,15,67650,101566,931,170147,931
2008,TX,16,60279,118178,1115,179572,1115
2008,TX,17,172822,82326,1992,257140,1992
2008,TX,18,43292,150973,868,195133,868
2008,TX,19,170969,65020,1693,237682,1693
2008,TX,20,64886,115739,1381,182006,1381
2008,TX,21,214669,149395,2952,367016,2952
2008,TX,22,183172,129414,1976,314562,1976
2008,TX,23,118391,124995,1634,245020,1634
2008,TX,24,153758,124128,1858,279744,1858
2008,TX,25,118197,176022,3392,297611,3392
2008,TX,26,193132,137613,2213,332958,2213
2008,TX,27,84366,97830,1283,183479,1283
2008,TX,28,80741,103458,999,185198,999
2008,TX,29,40884,66808,681,108373,681
2008,TX,30,37465,170826,827,209118,827
2008,TX,31,172570,124608,2879,300057,2879
2008,TX,32,110397,96203,1573,208173,1573
2008,UT,1,197457,103737,9175,310369,9175
2008,UT,2,202534,138790,9583,350907,9583
2008,UT,3,196063,85143,9904,291110,9904
2008,VT,AL,98974,219262,6810,325046,6810
2008,VA,1,193273,179442,3652,376367,3652
2008,VA,2,136725,142257,2991,281973,2991
2008,VA,3,72249,229822,2223,304294,2223
2008,VA,4,173358,178795,3087,355240,3087
2008,VA,5,164874,157362,3621,325857,3621
2008,VA,6,182573,134212,3869,320654,3869
2008,VA,7,205949,177789,3648,387386,3648
2008,VA,8,100234,234203,3594,338031,3594
2008,VA,9,160430,108220,4596,273246,4596
2008,VA,10,179337,205964,4025,389326,4025
2008,VA,11,156003,211466,3417,370886,3417
2008,WA,1,130343,226526,5911,362780,5911
2008,WA,2,151992,202480,7415,361887,7415
2008,WA,3,159803,183306,6898,350007,6898
2008,WA,4,159904,111423,5127,276454,5127
2008,WA,5,171426,152921,8283,332630,8283
2008,WA,6,128681,182446,6545,317672,6545
2008,WA,7,55200,308226,5536,368962,5536
2008,WA,8,155900,210998,5779,372677,5779
2008,WA,9,115837,172318,5298,293453,5298
2008,WV,1,141016,103096,4279,248391,4279
2008,WV,2,142112,113853,4175,260140,4175
2008,WV,3,114933,87178,4011,206122,4011
2008,WI,1,177162,191901,4281,373344,4281
2008,WI,2,123495,286089,5054,414638,5054
2008,WI,3,150618,213211,5327,369156,5327
2008,WI,4,73447,234468,3108,311023,3108
2008,WI,5,243597,174174,4191,421962,4191
2008,WI,6,176871,181198,4996,363065,4996
2008,WI,7,152507,200562,5624,358693,5624
2008,WI,8,164696,195608,4711,365015,4711
2008,WY,AL,164958,82868,6832,254658,6832
2012,AL,1,184786,111735,2316,298837,2316
2012,AL,2,182287,105572,2005,289864,2005
2012,AL,3,174465,103089,2574,280128,2574
2012,AL,4,205423,65818,3264,274505,3264
2012,AL,5,189860,103598,3805,297263,3805
2012,AL,6,233566,77517,3260,314343,3260
2012,AL,7,85488,228276,1480,315244,1480
2012,AK,AL,164676,122640,13179,300495,13179
2012,AZ,1,131115,124550,4391,260056,4391
2012,AZ,2,149651,144966,5074,299691,5074
2012,AZ,3,65482,108902,2864,177248,2864
2012,AZ,4,173394,80035,4617,258046,4617
2012,AZ,5,187304,101511,4933,293748,4933
2012,AZ,6,186537,121661,5219,313417,5219
2012,AZ,7,37353,101028,2526,140907,2526
2012,AZ,8,179555,107335,4236,291126,4236
2012,AZ,9,123263,135244,6056,264563,6056
2012,AR,1,154549,92086,6825,253460,6825
2012,AR,2,160140,125527,6848,292515,6848
2012,AR,3,168703,81413,7552,257668,7552
2012,AR,4,164352,95383,6090,265825,6090
2012,CA,1,171902,122379,9647,303928,9647
2012,CA,2,89908,230212,13322,333442,13322
2012,CA,3,104145,131237,6305,241687,6305
2012,CA,4,195386,133473,8775,337634,8775
2012,CA,5,78703,199924,8031,286658,8031
2012,CA,6,63862,156414,5555,225831,5555
2012,CA,7,133888,145147,6962,285997,6962
2012,CA,8,118278,88579,5776,212633,5776
2012,CA,9,88403,127418,4491,220312,4491
2012,CA,10,101160,108923,5030,215113,5030
2012,CA,11,90226,203699,7209,301134,7209
2012,CA,12,40003,269461,10923,320387,10923
2012,CA,13,27474,268093,10747,306314,10747
2012,CA,14,63589,200343,5950,269882,5950
2012,CA,15,77748,177243,5620,260611,5620
2012,CA,16,59808,88973,3172,151953,3172
2012,CA,17,58193,163862,5751,227806,5751
2012,CA,18,92457,218082,9076,319615,9076
2012,CA,19,61643,165530,5269,232442,5269
2012,CA,20,62427,168956,6958,238341,6958
2012,CA,21,51917,65146,2169,119232,2169
2012,CA,22,125213,92005,4060,221278,4060
2012,CA,23,139816,82119,5362,227297,5362
2012,CA,24,126049,158119,8238,292406,8238
2012,CA,25,125258,120701,6290,252249,6290
2012,CA,26,119677,147753,6217,273647,6217
2012,CA,27,90278,161528,6164,257970,6164
2012,CA,28,70757,187441,8430,266628,8430
2012,CA,29,34454,129323,4112,167889,4112
2012,CA,30,91680,186301,7245,285226,7245
2012,CA,31,83822,118043,4377,206242,4377
2012,CA,32,66269,133061,4839,204169,4839
2012,CA,33,127421,210010,9073,346504,9073
2012,CA,34,21739,127510,4450,153699,4450
2012,CA,35,49433,108983,3316,161732,3316
2012,CA,36,101156,107914,3869,212939,3869
2012,CA,37,33307,222329,6222,261858,6222
2012,CA,38,75780,149141,4954,229875,4954
2012,CA,39,133742,124108,5680,263530,5680
2012,CA,40,23446,115637,2835,141918,2835
2012,CA,41,67314,114040,4075,185429,4075
2012,CA,42,131438,96212,4870,232520,4870
2012,CA,43,44485,173342,4392,222219,4392
2012,CA,44,24995,155459,3132,183586,3132
2012,CA,45,169489,133114,6796,309399,6796
2012,CA,46,56252,95479,3762,155493,3762
2012,CA,47,92010,147456,6158,245624,6158
2012,CA,48,169249,133103,7144,309496,7144
2012,CA,49,153856,134447,6165,294468,6165
2012,CA,50,165104,102649,5536,273289,5536
2012,CA,51,48108,115610,2966,166684,2966
2012,CA,52,143726,163911,7111,314748,7111
2012,CA,53,103513,174616,6204,284333,6204
2012,CO,1,106334,254400,8064,368798,8064
2012,CO,2,174095,255209,11348,440652,11348
2012,CO,3,185459,163886,8700,358045,8700
2012,CO,4,209415,140404,8152,357971,8152
2012,CO,5,200491,129903,8749,339143,8749
2012,CO,6,165070,183024,6895,354989,6895
2012,CO,7,144379,196276,9265,349920,9265
2012,CT,1,112962,200910,3564,317436,3564
2012,CT,2,135212,177522,4908,317642,4908
2012,CT,3,110870,191210,3276,305356,3276
2012,CT,4,136527,170827,2735,310089,2735
2012,CT,5,139328,164636,3584,307548,3584
2012,DE,AL,165484,242584,5853,413921,5853
2012,DC,AL,21381,267070,5313,293764,5313
2012,FL,1,242972,106814,4095,353881,4095
2012,FL,2,178781,158751,3752,341284,3752
2012,FL,3,202003,122708,3801,328512,3801
2012,FL,4,222101,123537,3272,348910,3272
2012,FL,5,77757,197008,2008,276773,2008
2012,FL,6,209150,149955,3376,362481,3376
2012,FL,7,172042,156383,3637,332062,3637
2012,FL,8,206074,153138,3839,363051,3839
2012,FL,9,102173,170093,2347,274613,2347
2012,FL,10,174484,149532,3021,327037,3021
2012,FL,11,209720,143380,3282,356382,3282
2012,FL,12,185157,153386,4083,342626,4083
2012,FL,13,166087,171102,4208,341397,4208
2012,FL,14,99834,191255,2903,293992,2903
2012,FL,15,161622,138145,3286,303053,3286
2012,FL,16,194525,161079,3191,358795,3191
2012,FL,17,172038,122440,2731,297209,2731
2012,FL,18,177320,163067,2458,342845,2458
2012,FL,19,194512,124432,2081,321025,2081
2012,FL,20,44524,216650,1085,262259,1085
2012,FL,21,125821,196225,1794,323840,1794
2012,FL,22,147262,178218,2272,327752,2272
2012,FL,23,108855,176594,1701,287150,1701
2012,FL,24,31579,227669,809,260057,809
2012,FL,25,120291,115397,1178,236866,1178
2012,FL,26,123521,141449,1503,266473,1503
2012,FL,27,113241,129350,1218,243809,1218
2012,GA,1,145460,111949,2739,260148,2739
2012,GA,2,107242,153998,1597,262837,1597
2012,GA,3,195071,97746,3401,296218,3401
2012,GA,4,75951,218499,2483,296933,2483
2012,GA,5,45887,241217,3255,290359,3255
2012,GA,6,186807,115017,5272,307096,5272
2012,GA,7,158854,101065,3823,263742,3823
2012,GA,8,163908,99677,2378,265963,2378
2012,GA,9,207498,54388,3665,265551,3665
2012,GA,10,184160,107039,3652,294851,3652
2012,GA,11,201014,94447,4815,300276,4815
2012,GA,12,148688,117085,2510,268283,2510
2012,GA,13,87785,202794,2301,292880,2301
2012,GA,14,170364,58906,3432,232702,3432
2012,HI,1,62875,151023,2773,216671,2773
2012,HI,2,58140,155635,4251,218026,4251
2012,ID,1,213080,105645,9533,328258,9533
2012,ID,2,207831,107142,9043,324016,9043
2012,IL,1,67370,262785,2692,332847,2692
2012,IL,2,57674,251106,2352,311132,2352
2012,IL,3,109399,143694,3821,256914,3821
2012,IL,4,28895,137059,3471,169425,3471
2012,IL,5,90747,188332,6170,285249,6170
2012,IL,6,179608,151936,5393,336937,5393
2012,IL,7,35711,264093,2989,302793,2989
2012,IL,8,95034,133209,3886,232129,3886
2012,IL,9,102686,200648,5145,308479,5145
2012,IL,10,112556,157398,3663,273617,3663
2012,IL,11,107028,152265,4052,263345,4052
2012,IL,12,149164,153719,6603,309486,6603
2012,IL,13,147376,146441,7268,301085,7268
2012,IL,14,171584,139859,5151,316594,5151
2012,IL,15,197242,105064,6155,308461,6155
2012,IL,16,160614,137176,5914,303704,5914
2012,IL,17,119742,169689,5245,294676,5245
2012,IL,18,202786,125038,6481,334305,6481
2012,IN,1,111217,182021,4232,297470,4232
2012,IN,2,154837,116320,4847,276004,4847
2012,IN,3,179629,102536,5069,287234,5069
2012,IN,4,170242,103102,6314,279658,6314
2012,IN,5,196743,139300,6121,342164,6121
2012,IN,6,172452,106365,6534,285351,6534
2012,IN,7,92674,164902,4612,262188,4612
2012,IN,8,169317,114907,5861,290085,5861
2012,IN,9,173431,123435,6521,303387,6521
2012,IA,1,170753,225585,5163,401501,5163
2012,IA,2,168534,219946,5830,394310,5830
2012,IA,3,186645,203622,5531,395798,5531
2012,IA,4,204685,173391,5053,383129,5053
2012,KS,1,184287,72699,6040,263026,6040
2012,KS,2,163082,124370,7035,294487,7035
2012,KS,3,177886,146406,6194,330486,6194
2012,KS,4,164553,96433,6130,267116,6130
2012,KY,1,197074,95273,4444,296791,4444
2012,KY,2,186204,103432,4641,294277,4641
2012,KY,3,140539,183015,4835,328389,4835
2012,KY,4,197130,108328,5576,311034,5576
2012,KY,5,196166,60785,4530,261481,4530
2012,KY,6,170076,128537,6248,304861,6248
2012,LA,1,235877,89418,7628,332923,7628
2012,LA,2,74893,248982,4431,328306,4431
2012,LA,3,220490,107611,5472,333573,5472
2012,LA,4,191416,128612,4222,324250,4222
2012,LA,5,201058,124102,4371,329531,4371
2012,LA,6,228528,110416,6538,345482,6538
2012,ME,1,142573,221952,9305,373830,9305
2012,ME,2,148845,177283,9976,336104,9976
2012,MD,1,213073,133521,6795,353389,6795
2012,MD,2,109488,195997,6099,311584,6099
2012,MD,3,125439,204501,7334,337274,7334
2012,MD,4,67662,255910,3331,326903,3331
2012,MD,5,114638,234954,5348,354940,5348
2012,MD,6,137744,179172,6410,323326,6410
2012,MD,7,74614,251845,5052,331511,5052
2012,MD,8,129211,221944,6936,358091,6936
2012,MA,1,114339,213423,5916,333678,5916
2012,MA,2,133195,199549,7177,339921,7177
2012,MA,3,137869,189461,5595,332925,5595
2012,MA,4,152845,211895,5421,370161,5421
2012,MA,5,119934,235984,6095,362013,6095
2012,MA,6,169966,212003,5290,387259,5290
2012,MA,7,44275,233382,5374,283031,5374
2012,MA,8,150825,213364,5050,369239,5050
2012,MA,9,165212,212701,5076,382989,5076
2012,MI,1,189406,160199,4089,353694,4089
2012,MI,2,184755,142080,3150,329985,3150
2012,MI,3,177742,153069,3627,334438,3627
2012,MI,4,171864,146088,3463,321415,3463
2012,MI,5,129903,205800,3263,338966,3263
2012,MI,6,163309,158950,3241,325500,3241
2012,MI,7,169269,159012,3539,331820,3539
2012,MI,8,183512,172131,3152,358795,3152
2012,MI,9,146185,199625,3211,349021,3211
2012,MI,10,187653,148429,3236,339318,3236
2012,MI,11,199308,178768,2808,380884,2808
2012,MI,12,107675,217492,3331,328498,3331
2012,MI,13,41881,249656,1627,293164,1627
2012,MI,14,62794,273270,1427,337491,1427
2012,MN,1,165720,170377,7667,343764,7667
2012,MN,2,184576,184802,7208,376586,7208
2012,MN,3,195802,199093,6437,401332,6437
2012,MN,4,131521,231511,7482,370514,7482
2012,MN,5,89643,274635,9360,373638,9360
2012,MN,6,205652,151238,7182,364072,7182
2012,MN,7,180334,147750,6693,334777,6693
2012,MN,8,166977,186761,7499,361237,7499
2012,MS,1,197984,118438,3564,319986,3564
2012,MS,2,109228,219416,1899,330543,1899
2012,MS,3,204180,132968,2998,340146,2998
2012,MS,4,199354,92127,3428,294909,3428
2012,MO,1,66286,280194,4349,350829,4349
2012,MO,2,235428,170727,5837,411992,5837
2012,MO,3,219153,127442,6897,353492,6897
2012,MO,4,201678,119910,7713,329301,7713
2012,MO,5,133185,199298,5863,338346,5863
2012,MO,6,205280,129609,7058,341947,7058
2012,MO,7,220216,98916,6846,325978,6846
2012,MO,8,201214,97700,6523,305437,6523
2012,MT,AL,267928,201839,14717,484484,14717
2012,NE,1,152021,108082,5933,266036,5933
2012,NE,2,140976,121889,5162,268027,5162
2012,NE,3,182067,72110,6111,260288,6111
2012,NV,1,60813,123205,3668,187686,3668
2012,NV,2,155187,131542,6747,293476,6747
2012,NV,3,138238,140501,4917,283656,4917
2012,NV,4,109330,136124,4646,250100,4646
2012,NH,1,173419,179148,4245,356812,4245
2012,NH,2,156499,190413,4675,351587,4675
2012,NJ,1,110377,212236,3521,326134,3521
2012,NJ,2,141479,166906,3393,311778,3393
2012,NJ,3,163203,179028,3581,345812,3581
2012,NJ,4,180439,148622,3551,332612,3551
2012,NJ,5,172486,162305,3789,338580,3789
2012,NJ,6,99466,163391,3061,265918,3061
2012,NJ,7,178521,157635,4019,340175,4019
2012,NJ,8,43032,162232,2043,207307,2043
2012,NJ,9,77951,173082,2185,253218,2185
2012,NJ,10,31379,239483,1545,272407,1545
2012,NJ,11,183775,163493,3641,350909,3641
2012,NJ,12,96642,198197,3244,298083,3244
2012,NM,1,111749,155915,14531,282195,14531
2012,NM,2,119168,103438,7785,230391,7785
2012,NM,3,104871,155982,10318,271171,10318
2012,NY,1,145115,146708,3850,295673,3850
2012,NY,2,128791,140817,3055,272663,3055
2012,NY,3,147617,155451,3153,306221,3153
2012,NY,4,131750,173508,2861,308119,2861
2012,NY,5,19325,192374,648,212347,648
2012,NY,6,57455,125496,2107,185058,2107
2012,NY,7,18671,159552,2368,180591,2368
2012,NY,8,23869,210018,1408,235295,1408
2012,NY,9,33156,204281,2110,239547,2110
2012,NY,10,58992,173650,3179,235821,3179
2012,NY,11,101262,110407,2322,213991,2322
2012,NY,12,57575,205919,4198,267692,4198
2012,NY,13,10558,219361,1868,231787,1868
2012,NY,14,30978,136783,1791,169552,1791
2012,NY,15,5315,171366,448,177129,448
2012,NY,16,68373,197365,2076,267814,2076
2012,NY,17,123190,168020,3191,294401,3191
2012,NY,18,137144,149610,4140,290894,4140
2012,NY,19,138981,157967,6164,303112,6164
2012,NY,20,122230,186460,6342,315032,6342
2012,NY,21,122471,138889,4490,265850,4490
2012,NY,22,136500,135172,5545,277217,5545
2012,NY,23,137312,133949,5630,276891,5630
2012,NY,24,123534,171502,5585,300621,5585
2012,NY,25,125897,187753,5804,319454,5804
2012,NY,26,103743,193362,5283,302388,5283
2012,NY,27,180703,140176,5949,326828,5949
2012,NC,1,96402,247611,1796,345809,1796
2012,NC,2,183972,134016,3304,321292,3304
2012,NC,3,183925,130053,3180,317158,3180
2012,NC,4,99068,258202,4212,361482,4212
2012,NC,5,208869,140633,4127,353629,4127
2012,NC,6,214871,154073,3769,372713,3769
2012,NC,7,202259,136091,3093,341443,3093
2012,NC,8,178731,126223,2875,307829,2875
2012,NC,9,216215,164739,3836,384790,3836
2012,NC,10,197769,139439,3768,340976,3768
2012,NC,11,205553,127563,4434,337550,4434
2012,NC,12,66088,249654,2128,317870,2128
2012,NC,13,216674,170093,3992,390759,3992
2012,ND,AL,188163,124827,9637,322627,9637
2012,OH,1,190504,168195,4894,363593,4894
2012,OH,2,194409,155027,5681,355117,5681
2012,OH,3,90434,217969,4535,312938,4535
2012,OH,4,185512,139228,6650,331390,6650
2012,OH,5,195075,159592,7385,362052,7385
2012,OH,6,176593,136522,6824,319939,6824
2012,OH,7,179312,147660,6894,333866,6894
2012,OH,8,211436,124478,5629,341543,5629
2012,OH,9,99223,217146,5085,321454,5085
2012,OH,10,179813,172942,5837,358592,5837
2012,OH,11,59753,298788,2583,361124,2583
2012,OH,12,207387,167441,6634,381462,6634
2012,OH,13,119625,212616,5535,337776,5535
2012,OH,14,192270,179769,5794,377833,5794
2012,OH,15,180443,161227,6253,347923,6253
2012,OH,16,199650,169108,5451,374209,5451
2012,OK,1,188961,98321,0,287282,0
2012,OK,2,170983,81179,0,252162,0
2012,OK,3,199390,70346,0,269736,0
2012,OK,4,175956,86357,0,262313,0
2012,OK,5,156035,107344,0,263379,0
2012,OR,1,140410,201028,9541,350979,9541
2012,OR,2,196568,139940,9375,345883,9375
2012,OR,3,91827,267966,12243,372036,12243
2012,OR,4,163931,188563,11946,364440,11946
2012,OR,5,161439,172991,8227,342657,8227
2012,PA,1,50211,244605,2553,297369,2553
2012,PA,2,33525,338543,2391,374459,2391
2012,PA,3,171119,132483,4166,307768,4166
2012,PA,4,177711,129246,4424,311381,4424
2012,PA,5,165210,119958,4917,290085,4917
2012,PA,6,174379,165916,4502,344797,4502
2012,PA,7,183955,177252,4040,365247,4040
2012,PA,8,178195,177940,4454,360589,4454
2012,PA,9,176706,100903,3689,281298,3689
2012,PA,10,170276,108913,4073,283262,4073
2012,PA,11,157834,130411,4478,292723,4478
2012,PA,12,200365,141906,4302,346573,4302
2012,PA,13,104711,210561,2940,318212,2940
2012,PA,14,103977,230750,4672,339399,4672
2012,PA,15,156170,147239,4144,307553,4144
2012,PA,16,153189,135331,4077,292597,4077
2012,PA,17,121870,156019,3821,281710,3821
2012,PA,18,200985,142178,3692,346855,3692
2012,RI,1,68685,141332,3443,213460,3443
2012,RI,2,88519,138345,4344,231208,4344
2012,SC,1,173550,119756,4627,297933,4627
2012,SC,2,170005,113338,4100,287443,4100
2012,SC,3,170173,89494,3971,263638,3971
2012,SC,4,170679,99387,4488,274554,4488
2012,SC,5,157710,124832,3658,286200,3658
2012,SC,6,77299,195131,2836,275266,2836
2012,SC,7,152230,124002,2853,279085,2853
2012,SD,AL,210610,145039,8166,363815,8166
2012,TN,1,186323,65770,4247,256340,4247
2012,TN,2,186355,85522,5059,276936,5059
2012,TN,3,171967,95262,4504,271733,4504
2012,TN,4,169824,86058,4069,259951,4069
2012,TN,5,116289,152960,4627,273876,4627
2012,TN,6,192602,82276,3967,278845,3967
2012,TN,7,183782,92081,3998,279861,3998
2012,TN,8,201555,100140,3195,304890,3195
2012,TN,9,53633,200640,1872,256145,1872
2012,TX,1,181835,69858,2362,254055,2362
2012,TX,2,157094,88751,3724,249569,3724
2012,TX,3,175383,93290,3991,272664,3991
2012,TX,4,189554,63559,3010,256123,3010
2012,TX,5,137239,73085,2345,212669,2345
2012,TX,6,146985,103444,3366,253795,3366
2012,TX,7,143631,92499,3637,239767,3637
2012,TX,8,195742,55273,3152,254167,3152
2012,TX,9,39392,145332,1543,186267,1543
2012,TX,10,159714,104839,5583,270136,5583
2012,TX,11,182355,45070,2906,230331,2906
2012,TX,12,166992,79147,3687,249826,3687
2012,TX,13,184104,42521,2920,229545,2920
2012,TX,14,147213,97958,2902,248073,2902
2012,TX,15,62884,86943,1525,151352,1525
2012,TX,16,54315,100993,2106,157414,2106
2012,TX,17,135309,84531,4239,224079,4239
2012,TX,18,44991,150129,2086,197206,2086
2012,TX,19,160141,54461,3017,217619,3017
2012,TX,20,74540,110663,2632,187835,2632
2012,TX,21,188241,119220,7130,314591,7130
2012,TX,22,158452,93582,3009,255043,3009
2012,TX,23,99672,94414,2324,196410,2324
2012,TX,24,150547,94634,3899,249080,3899
2012,TX,25,162279,102433,6095,270807,6095
2012,TX,26,177941,80828,4427,263196,4427
2012,TX,27,131821,83157,2793,217771,2793
2012,TX,28,65373,101841,1659,168873,1659
2012,TX,29,37909,75720,1272,114901,1272
2012,TX,30,43333,175637,1595,220565,1595
2012,TX,31,144634,92842,5238,242714,5238
2012,TX,32,146420,106563,3890,256873,3890
2012,TX,33,32641,86686,1153,120480,1153
2012,TX,34,57303,90885,1323,149511,1323
2012,TX,35,57989,105545,3933,167467,3933
2012,TX,36,175883,61786,2764,240433,2764
2012,UT,1,193672,51098,5508,250278,5508
2012,UT,2,173513,74556,7132,255201,7132
2012,UT,3,208121,51791,5944,265856,5944
2012,UT,4,165294,74368,6404,246066,6404
2012,VT,AL,92698,199239,7353,299290,7353
2012,VA,1,193647,166510,4883,365040,4883
2012,VA,2,154935,159695,4219,318849,4219
2012,VA,3,66391,262265,3510,332166,3510
2012,VA,4,181265,176311,3920,361496,3920
2012,VA,5,188485,164555,5649,358689,5649
2012,VA,6,197045,132153,5666,334864,5666
2012,VA,7,222915,163331,5236,391482,5236
2012,VA,8,111518,243746,4479,359743,4479
2012,VA,9,196354,108641,6296,311291,6296
2012,VA,10,186650,182432,4831,373913,4831
2012,VA,11,123317,212181,4212,339710,4212
2012,WA,1,147074,183802,8613,339489,8613
2012,WA,2,119266,185771,8631,313668,8631
2012,WA,3,150409,145442,7632,303483,7632
2012,WA,4,142741,90612,5587,238940,5587
2012,WA,5,168671,137771,8983,315425,8983
2012,WA,6,135573,184820,8797,329190,8797
2012,WA,7,70973,310828,10618,392419,10618
2012,WA,8,151069,155982,6916,313967,6916
2012,WA,9,84828,195863,6184,286875,6184
2012,WA,10,120066,164505,7489,292060,7489
2012,WV,1,141736,81017,5195,227948,5195
2012,WV,2,140783,89079,4734,234596,4734
2012,WV,3,135136,68173,4585,207894,4585
2012,WI,1,195835,179872,3477,379184,3477
2012,WI,2,126688,284084,5170,415942,5170
2012,WI,3,159205,199188,4942,363335,4942
2012,WI,4,84751,268440,3164,356355,3164
2012,WI,5,257017,158226,3948,419191,3948
2012,WI,6,202979,174988,4328,382295,4328
2012,WI,7,190364,178841,4671,373876,4671
2012,WI,8,191127,177346,4413,372886,4413
2012,WY,AL,170962,69286,8813,249061,8813
2016,AL,1,192637,103364,7477,303478,7477
2016,AL,2,185505,94299,5860,285664,5860
2016,AL,3,188477,93300,6999,288776,6999
2016,AL,4,233661,50722,6343,290726,6343
2016,AL,5,200571,97159,12207,309937,12207
2016,AL,6,233493,86116,10240,329849,10240
2016,AL,7,83915,204586,4730,293231,4730
2016,AK,AL,163387,116454,38767,318608,38767
2016,AZ,1,135928,132874,23005,291807,23005
2016,AZ,2,141196,156676,24302,322174,24302
2016,AZ,3,67952,130466,13521,211939,13521
2016,AZ,4,202043,82192,18861,303096,18861
2016,AZ,5,191432,121280,28713,341425,28713
2016,AZ,6,177332,143571,23080,343983,23080
2016,AZ,7,37232,117958,11991,167181,11991
2016,AZ,8,190163,120992,21595,332750,21595
2016,AZ,9,109123,155158,25944,290225,25944
2016,AR,1,169438,78688,12591,260717,12591
2016,AR,2,160782,127883,18309,306974,18309
2016,AR,3,180921,89081,22161,292163,22161
2016,AR,4,173731,84842,12208,270781,12208
2016,CA,1,176358,114727,22883,313968,22883
2016,CA,2,80545,238157,26269,344971,26269
2016,CA,3,105860,138882,17344,262086,17344
2016,CA,4,190924,138790,23674,353388,23674
2016,CA,5,74088,210950,20014,305052,20014
2016,CA,6,59549,168687,15674,243910,15674
2016,CA,7,124249,159066,20803,304118,20803
2016,CA,8,127464,92234,13137,232835,13137
2016,CA,9,90484,134719,12988,238191,12988
2016,CA,10,109145,116335,14200,239680,14200
2016,CA,11,70869,223559,18140,312568,18140
2016,CA,12,31158,309221,18395,358774,18395
2016,CA,13,22743,291926,19525,334194,19525
2016,CA,14,54229,229008,14506,297743,14506
2016,CA,15,68808,198964,16764,284536,16764
2016,CA,16,61813,98504,9647,169964,9647
2016,CA,17,50926,183801,13968,248695,13968
2016,CA,18,67808,246015,21315,335138,21315
2016,CA,19,55371,187828,14425,257624,14425
2016,CA,20,59573,180486,16479,256538,16479
2016,CA,21,52972,73773,6799,133544,6799
2016,CA,22,125089,102292,12756,240137,12756
2016,CA,23,142351,88314,14199,244864,14199
2016,CA,24,113887,176979,21294,312160,21294
2016,CA,25,119249,137491,16478,273218,16478
2016,CA,26,105259,169083,17890,292232,17890
2016,CA,27,74984,174544,14938,264466,14938
2016,CA,28,64607,208645,16002,289254,16002
2016,CA,29,32963,152517,10716,196196,10716
2016,CA,30,77701,209149,15955,302805,15955
2016,CA,31,83701,131960,13164,228825,13164
2016,CA,32,60921,146459,12666,220046,12666
2016,CA,33,93706,239982,20209,353897,20209
2016,CA,34,19784,154259,10558,184601,10558
2016,CA,35,50822,127757,10032,188611,10032
2016,CA,36,103051,123795,10524,237370,10524
2016,CA,37,26608,236621,12905,276134,12905
2016,CA,38,68033,166224,13967,248224,13967
2016,CA,39,116782,140230,15459,272471,15459
2016,CA,40,21077,135472,8165,164714,8165
2016,CA,41,68526,126197,12238,206961,12238
2016,CA,42,143175,111103,14027,268305,14027
2016,CA,43,39039,183434,11587,234060,11587
2016,CA,44,24261,164251,9290,197802,9290
2016,CA,45,144713,162449,18805,325967,18805
2016,CA,46,50403,119762,10585,180750,10585
2016,CA,47,80162,161743,16415,258320,16415
2016,CA,48,146595,152035,18698,317328,18698
2016,CA,49,135576,159081,19354,314011,19354
2016,CA,50,159822,115864,17192,292878,17192
2016,CA,51,46825,147603,11009,205437,11009
2016,CA,52,117057,191325,20876,329258,20876
2016,CA,53,91822,200237,18314,310373,18314
2016,CO,1,93486,277790,31187,402463,31187
2016,CO,2,164710,264925,41673,471308,41673
2016,CO,3,195966,151057,30153,377176,30153
2016,CO,4,230945,137779,33473,402197,33473
2016,CO,5,212517,123508,35726,371751,35726
2016,CO,6,157115,191103,32317,380535,32317
2016,CO,7,147645,192637,34334,374616,34334
2016,CT,1,119395,195305,14535,329235,14535
2016,CT,2,155975,165799,19635,341409,19635
2016,CT,3,129968,179832,12480,322280,12480
2016,CT,4,119976,195494,13318,328788,13318
2016,CT,5,147901,161142,14157,323200,14157
2016,DE,AL,185127,235603,20860,441590,20860
2016,DC,AL,12723,282830,15715,311268,15715
2016,FL,1,256609,107063,16428,380100,16428
2016,FL,2,234991,108636,11321,354948,11321
2016,FL,3,197478,141362,12848,351688,12848
2016,FL,4,261826,143675,16117,421618,16117
2016,FL,5,111892,191194,8985,312071,8985
2016,FL,6,215941,151453,12410,379804,12410
2016,FL,7,160178,186658,16350,363186,16350
2016,FL,8,234648,151412,15851,401911,15851
2016,FL,9,149352,195368,11810,356530,11810
2016,FL,10,110062,194934,10615,315611,10615
2016,FL,11,266256,133448,11294,410998,11294
2016,FL,12,218487,147759,14111,380357,14111
2016,FL,13,167348,178892,14520,360760,14520
2016,FL,14,128797,188870,12766,330433,12766
2016,FL,15,177635,144225,12658,334518,12658
2016,FL,16,213271,170442,13094,396807,13094
2016,FL,17,220156,123919,9786,353861,9786
2016,FL,18,203771,168558,10145,382474,10145
2016,FL,19,227097,143001,11060,381158,11060
2016,FL,20,52251,231596,4964,288811,4964
2016,FL,21,137490,206239,7932,351661,7932
2016,FL,22,146228,202355,7899,356482,7899
2016,FL,23,120967,209079,7736,337782,7736
2016,FL,24,40234,218424,4538,263196,4538
2016,FL,25,131186,126702,6367,264255,6367
2016,FL,26,115529,161555,7651,284735,7651
2016,FL,27,118206,178154,7770,304130,7770
2016,GA,1,151996,110190,7382,269568,7382
2016,GA,2,107361,136455,4287,248103,4287
2016,GA,3,200624,102155,9086,311865,9086
2016,GA,4,66433,224907,7323,298663,7323
2016,GA,5,36385,259805,9564,305754,9564
2016,GA,6,160022,155077,16147,331246,16147
2016,GA,7,150845,132012,12115,294972,12115
2016,GA,8,168193,91360,5961,265514,5961
2016,GA,9,231194,57468,8553,297215,8553
2016,GA,10,193030,112691,9352,315073,9352
2016,GA,11,198813,116457,14345,329615,14345
2016,GA,12,152204,108937,6533,267674,6533
2016,GA,13,80157,213936,7145,301238,7145
2016,GA,14,191849,56513,7510,255872,7510
2016,HI,1,63916,132009,13375,209300,13375
2016,HI,2,64931,134882,19824,219637,19824
2016,ID,1,229034,91284,39465,359783,39465
2016,ID,2,180021,98481,52148,330650,52148
2016,IL,1,69956,245908,10311,326175,10311
2016,IL,2,58024,236726,8872,303622,8872
2016,IL,3,113779,157383,13808,284970,13808
2016,IL,4,27807,172374,9750,209931,9750
2016,IL,5,78069,229937,18030,326036,18030
2016,IL,6,152909,177578,23279,353766,23279
2016,IL,7,28580,271100,10479,310159,10479
2016,IL,8,92926,148233,13905,255064,13905
2016,IL,9,84456,238096,17035,339587,17035
2016,IL,10,94108,178857,15338,288303,15338
2016,IL,11,99104,164632,15884,279620,15884
2016,IL,12,173693,126817,15336,315846,15336
2016,IL,13,159013,141541,19425,319979,19425
2016,IL,14,167348,153989,22080,343417,22080
2016,IL,15,226605,78574,15263,320442,15263
2016,IL,16,173093,119542,19353,311988,19353
2016,IL,17,136017,133999,17087,287103,17087
2016,IL,18,210529,115442,21163,347134,21163
2016,IN,1,124638,162358,13287,300283,13287
2016,IN,2,163527,99496,12905,275928,12905
2016,IN,3,189573,87697,13903,291173,13903
2016,IN,4,194402,91264,16704,302370,16704
2016,IN,5,192998,150081,20505,363584,20505
2016,IN,6,204129,82498,14897,301524,14897
2016,IN,7,95625,156015,12685,264325,12685
2016,IN,8,194208,92844,13569,300621,13569
2016,IN,9,198106,110835,15534,324475,15534
2016,IA,1,190410,176535,28688,395633,28688
2016,IA,2,186384,170796,27315,384495,27315
2016,IA,3,192960,178937,30267,402164,30267
2016,IA,4,231229,127401,25109,383739,25109
2016,KS,1,183448,64389,16927,264764,16927
2016,KS,2,165000,110596,20061,295657,20061
2016,KS,3,157304,161479,23184,341967,23184
2016,KS,4,165266,90541,18740,274547,18740
2016,KY,1,224657,74179,11463,310299,11463
2016,KY,2,219152,89563,15797,324512,15797
2016,KY,3,135714,186549,17780,340043,17780
2016,KY,4,219749,98664,18736,337149,18736
2016,KY,5,221558,48628,8197,278383,8197
2016,KY,6,182141,131271,19600,333012,19600
2016,LA,1,244907,95169,16406,356482,16406
2016,LA,2,73779,247490,10433,331702,10433
2016,LA,3,231017,100241,11767,343025,11767
2016,LA,4,192977,116599,8886,318462,8886
2016,LA,5,205258,110259,7892,323409,7892
2016,LA,6,230700,110395,14856,355951,14856
2016,ME,1,154127,210979,27001,392107,27001
2016,ME,2,180818,143739,27277,351834,27277
2016,MD,1,225249,121841,16827,363917,16827
2016,MD,2,114461,193236,13537,321234,13537
2016,MD,3,113317,221842,17468,352627,17468
2016,MD,4,63390,256575,10150,330115,10150
2016,MD,5,115868,225989,13571,355428,13571
2016,MD,6,134827,189512,15224,339563,15224
2016,MD,7,63444,233796,12609,309849,12609
2016,MD,8,112613,235137,16166,363916,16166
2016,MA,1,123953,194036,26423,344412,26423
2016,MA,2,129437,197492,30466,357395,30466
2016,MA,3,123347,202952,28068,354367,28068
2016,MA,4,133705,225976,28971,388652,28971
2016,MA,5,95922,258908,24890,379720,24890
2016,MA,6,153244,224858,29794,407896,29794
2016,MA,7,36018,254037,16061,306116,16061
2016,MA,8,131624,231356,26155,389135,26155
2016,MA,9,163643,205581,28129,397353,28129
2016,MI,1,210576,133082,22639,366297,22639
2016,MI,2,192461,131996,24720,349177,24720
2016,MI,3,179932,147650,25828,353410,25828
2016,MI,4,194565,113237,21055,328857,21055
2016,MI,5,148437,162737,17893,329067,17893
2016,MI,6,169978,142042,20547,332567,20547
2016,MI,7,188755,129885,21655,340295,21655
2016,MI,8,189891,164436,24113,378440,24113
2016,MI,9,155597,183085,18212,356894,18212
2016,MI,10,228009,112997,16800,357806,16800
2016,MI,11,194245,177143,23251,394639,23251
2016,MI,12,116625,205662,18940,341227,18940
2016,MI,13,48111,209105,9578,266794,9578
2016,MI,14,58179,252387,10031,320597,10031
2016,MN,1,181647,130831,31257,343735,31257
2016,MN,2,176088,171396,34583,382067,34583
2016,MN,3,164259,201833,35578,401670,35578
2016,MN,4,111163,223803,32688,367654,32688
2016,MN,5,68535,273402,32623,374560,32623
2016,MN,6,218546,123329,32045,373920,32045
2016,MN,7,208215,104566,26505,339286,26505
2016,MN,8,194779,138665,28897,362341,28897
2016,MS,1,203144,100770,6708,310622,6708
2016,MS,2,102392,185208,3827,291427,3827
2016,MS,3,198527,119108,6218,323853,6218
2016,MS,4,196652,80045,6758,283455,6758
2016,MO,1,60136,246107,13363,319606,13363
2016,MO,2,220842,177647,21583,420072,21583
2016,MO,3,254183,106365,18298,378846,18298
2016,MO,4,222162,99844,18284,340290,18284
2016,MO,5,133458,177772,17573,328803,17573
2016,MO,6,223375,112056,18583,354014,18583
2016,MO,7,240690,84419,16960,342069,16960
2016,MO,8,239666,66858,11225,317749,11225
2016,MT,AL,279240,177709,44872,501821,44872
2016,NE,1,158626,100126,23586,282338,23586
2016,NE,2,137564,131030,23086,291680,23086
2016,NE,3,199657,53290,17087,270034,17087
2016,NV,1,64233,121321,11286,196840,11286
2016,NV,2,169631,129318,27062,326011,27062
2016,NV,3,154815,151552,19235,325602,19235
2016,NV,4,123380,137070,16482,276932,16482
2016,NH,1,179259,173344,24740,377343,24740
2016,NH,2,166531,175182,24736,366449,24736
2016,NJ,1,118880,199386,14576,332842,14576
2016,NJ,2,162486,147656,13636,323778,13636
2016,NJ,3,187703,165090,15878,368671,15878
2016,NJ,4,198859,146191,15360,360410,15360
2016,NJ,5,177774,172962,15725,366461,15725
2016,NJ,6,116815,162015,11369,290199,11369
2016,NJ,7,176386,180525,17493,374404,17493
2016,NJ,8,49336,173834,7786,230956,7786
2016,NJ,9,91638,177685,8680,278003,8680
2016,NJ,10,35111,233822,6648,275581,6648
2016,NJ,11,185696,182334,16781,384811,16781
2016,NJ,12,99321,203731,12375,315427,12375
2016,NM,1,100132,147250,37788,285170,37788
2016,NM,2,117210,93364,23521,234095,23521
2016,NM,3,102324,144620,32109,279053,32109
2016,NY,1,183233,141900,13710,338843,13710
2016,NY,2,165908,137680,11633,315221,11633
2016,NY,3,156942,178288,12786,348016,12786
2016,NY,4,147469,179845,12120,339434,12120
2016,NY,5,31322,211667,4777,247766,4777
2016,NY,6,66487,134970,7208,208665,7208
2016,NY,7,21198,177664,6871,205733,6871
2016,NY,8,34356,215689,6057,256102,6057
2016,NY,9,36600,211812,6945,255357,6945
2016,NY,10,49179,205114,10508,264801,10508
2016,NY,11,133232,108807,8044,250083,8044
2016,NY,12,41383,255601,13318,310302,13318
2016,NY,13,13727,232925,7023,253675,7023
2016,NY,14,38560,151407,5916,195883,5916
2016,NY,15,9371,179454,3069,191894,3069
2016,NY,16,63590,212644,9161,285395,9161
2016,NY,17,122339,186437,12432,321208,12432
2016,NY,18,152140,146186,14850,313176,14850
2016,NY,19,162263,140517,20376,323156,20376
2016,NY,20,131559,175390,22271,329220,22271
2016,NY,21,150481,111760,21206,283447,21206
2016,NY,22,158913,114016,20104,293033,20104
2016,NY,23,158167,115021,20139,293327,20139
2016,NY,24,139763,151021,19647,310431,19647
2016,NY,25,128955,182896,21476,333327,21476
2016,NY,26,115558,175336,14241,305135,14241
2016,NY,27,206854,122091,19987,348932,19987
2016,NC,1,108100,239585,7019,354704,7019
2016,NC,2,211450,173131,12586,397167,12586
2016,NC,3,198843,121070,8490,328403,8490
2016,NC,4,116383,281517,14633,412533,14633
2016,NC,5,204207,142028,10255,356490,10255
2016,NC,6,201437,148761,8743,358941,8743
2016,NC,7,206150,142809,8949,357908,8949
2016,NC,8,185875,136233,9128,331236,9128
2016,NC,9,186989,147084,9842,343915,9842
2016,NC,10,218369,130711,9189,358269,9189
2016,NC,11,229545,122682,10193,362420,10193
2016,NC,12,101161,243736,11424,356321,11424
2016,NC,13,194119,159968,9676,363763,9676
2016,ND,AL,216794,93758,33808,344360,33808
2016,OH,1,185025,160988,15284,361297,15284
2016,OH,2,197877,140773,16218,354868,16218
2016,OH,3,89824,210445,13886,314155,13886
2016,OH,4,208715,99641,16292,324648,16292
2016,OH,5,214653,124410,20561,359624,20561
2016,OH,6,221852,85512,12700,320064,12700
2016,OH,7,205565,108004,15369,328938,15369
2016,OH,8,223221,104927,14637,342785,14637
2016,OH,9,110204,177118,14333,301655,14333
2016,OH,10,178703,153323,16155,348181,16155
2016,OH,11,55018,260298,7985,323301,7985
2016,OH,12,205883,162245,19151,387279,19151
2016,OH,13,142800,163553,13524,319877,13524
2016,OH,14,197884,155602,15788,369274,15788
2016,OH,15,196679,141654,17057,355390,17057
2016,OH,16,207101,145672,16064,368837,16064
2016,OK,1,191343,101757,18406,311506,18406
2016,OK,2,198155,62022,11667,271844,11667
2016,OK,3,216078,61179,16160,293417,16160
2016,OK,4,194160,83648,17656,295464,17656
2016,OK,5,149400,111769,19592,280761,19592
2016,OR,1,132195,219369,47385,398949,47385
2016,OR,2,215711,139059,39351,394121,39351
2016,OR,3,89631,282402,40742,412775,40742
2016,OR,4,180318,180872,45144,406334,45144
2016,OR,5,164548,180404,44205,389157,44205
2016,PA,1,57521,250924,7160,315605,7160
2016,PA,2,28067,334322,7367,369756,7367
2016,PA,3,197960,113563,12680,324203,12680
2016,PA,4,198571,125762,14354,338687,14354
2016,PA,5,195736,105138,13269,314143,13269
2016,PA,6,175340,177639,15575,368554,15575
2016,PA,7,181455,190599,14285,386339,14285
2016,PA,8,186607,185685,14733,387025,14733
2016,PA,9,213383,83263,9291,305937,9291
2016,PA,10,204114,93240,11598,308952,11598
2016,PA,11,191473,115480,12082,319035,12082
2016,PA,12,213003,137482,12654,363139,12654
2016,PA,13,105558,217268,9819,332645,9819
2016,PA,14,107100,231552,12122,350774,12122
2016,PA,15,173597,148080,13192,334869,13192
2016,PA,16,161763,140186,15070,317019,15070
2016,PA,17,163730,132702,10209,306641,10209
2016,PA,18,215102,142705,12691,370498,12691
2016,RI,1,75510,130682,14074,220266,14074
2016,RI,2,105033,121843,16904,243780,16904
2016,SC,1,178052,134685,20284,333021,20284
2016,SC,2,175985,120591,16049,312625,16049
2016,SC,3,190540,82527,11281,284348,11281
2016,SC,4,181634,103975,16138,301747,16138
2016,SC,5,175391,118791,12018,306200,12018
2016,SC,6,80741,178159,7948,266848,7948
2016,SC,7,173046,116645,8546,298237,8546
2016,SD,AL,227721,117458,24914,370093,24914
2016,TN,1,203668,52240,9585,265493,9585
2016,TN,2,188956,86214,15023,290193,15023
2016,TN,3,180932,83524,12001,276457,12001
2016,TN,4,189613,75831,11138,276582,11138
2016,TN,5,105776,156608,14575,276959,14575
2016,TN,6,216461,70549,10957,297967,10957
2016,TN,7,196848,82313,12400,291561,12400
2016,TN,8,196702,91025,8945,296672,8945
2016,TN,9,43970,172391,5992,222353,5992
2016,TX,1,189596,66389,8566,264551,8566
2016,TX,2,145530,119659,14702,279891,14702
2016,TX,3,174561,129384,20359,324304,20359
2016,TX,4,210448,60799,9876,281123,9876
2016,TX,5,145846,79759,7735,233340,7735
2016,TX,6,148945,115272,12736,276953,12736
2016,TX,7,121204,124722,13027,258953,13027
2016,TX,8,214567,70520,13228,298315,13228
2016,TX,9,34447,151559,5507,191513,5507
2016,TX,10,164817,135967,16777,317561,16777
2016,TX,11,193619,47470,8593,249682,8593
2016,TX,12,177939,92549,14519,285007,14519
2016,TX,13,190779,40237,8844,239860,8844
2016,TX,14,153191,101228,9919,264338,9919
2016,TX,15,73689,104454,7676,185819,7676
2016,TX,16,52334,130784,11485,194603,11485
2016,TX,17,139411,96155,14623,250189,14623
2016,TX,18,41011,157117,8007,206135,8007
2016,TX,19,165280,53512,10793,229585,10793
2016,TX,20,74479,132453,13050,219982,13050
2016,TX,21,188277,152515,21902,362694,21902
2016,TX,22,159717,135525,13411,308653,13411
2016,TX,23,107058,115133,10945,233136,10945
2016,TX,24,140129,122878,14490,277497,14490
2016,TX,25,172462,125947,16952,315361,16952
2016,TX,26,194032,109530,18473,322035,18473
2016,TX,27,140787,85589,9029,235405,9029
2016,TX,28,72479,109973,7795,190247,7795
2016,TX,29,34011,95027,4896,133934,4896
2016,TX,30,40333,174528,5850,220711,5850
2016,TX,31,153823,117181,21423,292427,21423
2016,TX,32,129701,134895,13867,278463,13867
2016,TX,33,30787,94513,4567,129867,4567
2016,TX,34,64716,101704,5763,172183,5763
2016,TX,35,61139,128482,12412,202033,12412
2016,TX,36,183144,64217,8149,255510,8149
2016,UT,1,139503,62733,78206,280442,78206
2016,UT,2,130525,90686,62488,283699,62488
2016,UT,3,136782,67461,85680,289923,85680
2016,UT,4,108421,89796,79094,277311,79094
2016,VT,AL,95369,178573,41125,315067,41125
2016,VA,1,212402,163522,23157,399081,23157
2016,VA,2,156283,145171,20966,322420,20966
2016,VA,3,103064,205746,16490,325300,16490
2016,VA,4,134676,212677,16990,364343,16990
2016,VA,5,195190,154665,17646,367501,17646
2016,VA,6,206303,120596,20897,347796,20897
2016,VA,7,198032,172544,24028,394604,24028
2016,VA,8,76854,270415,26152,373421,26152
2016,VA,9,217837,86463,13993,318293,13993
2016,VA,10,170580,210692,27275,408547,27275
2016,VA,11,98222,238982,24242,361446,24242
2016,WA,1,132109,188952,40318,361379,40318
2016,WA,2,113670,185821,36980,336471,36980
2016,WA,3,157359,134009,35634,327002,35634
2016,WA,4,140560,85083,25250,250893,25250
2016,WA,5,166765,125112,39458,331335,39458
2016,WA,6,131449,172596,40092,344137,40092
2016,WA,7,50615,341412,33910,425937,33910
2016,WA,8,143403,153167,36225,332795,36225
2016,WA,9,67956,205193,26173,299322,26173
2016,WA,10,117861,151373,36400,305634,36400
2016,WV,1,165934,64384,16627,246945,16627
2016,WV,2,164674,73487,15131,253292,15131
2016,WV,3,158763,50923,11308,220994,11308
2016,WI,1,187372,150436,22007,359815,22007
2016,WI,2,119608,271507,27077,418192,27077
2016,WI,3,177172,160999,25100,363271,25100
2016,WI,4,67287,228226,16968,312481,16968
2016,WI,5,229325,148900,27422,405647,27422
2016,WI,6,203433,141917,25759,371109,25759
2016,WI,7,213467,137874,21860,373201,21860
2016,WI,8,207620,142677,22137,372434,22137
2016,WY,AL,174419,55973,25457,255849,25457
2020,AL,1,211419,117089,4269,332777,4269
2020,AL,2,197261,106429,3741,307431,3741
2020,AL,3,210595,110978,4058,325631,4058
2020,AL,4,260264,57440,3766,321470,3766
2020,AL,5,228396,130254,6960,365610,6960
2020,AL,6,248657,117142,7035,372834,7035
2020,AL,7,84575,210754,3383,298712,3383
2020,AK,AL,189951,153778,15801,359530,15801
2020,AZ,1,180673,187182,5724,373579,5724
2020,AZ,2,171803,213408,6225,391436,6225
2020,AZ,3,99539,174882,4076,278497,4076
2020,AZ,4,280122,126024,5792,411938,5792
2020,AZ,5,262810,195270,7518,465598,7518
2020,AZ,6,222166,204365,5797,432328,5797
2020,AZ,7,55436,165129,3603,224168,3603
2020,AZ,8,251443,181691,5818,438952,5818
2020,AZ,9,137694,224192,6912,368798,6912
2020,AR,1,187640,75898,8174,271712,8174
2020,AR,2,177053,147552,8742,333347,8742
2020,AR,3,207781,118142,9931,335854,9931
2020,AR,4,188173,82340,7643,278156,7643
2020,CA,1,203608,148439,9490,361537,9490
2020,CA,2,95641,294471,10433,400545,10433
2020,CA,3,139683,179793,8085,327561,8085
2020,CA,4,240834,197122,10861,448817,10861
2020,CA,5,92093,264115,8416,364624,8416
2020,CA,6,87284,225218,8141,320643,8141
2020,CA,7,164052,218137,9883,392072,9883
2020,CA,8,158451,127769,6949,293169,6949
2020,CA,9,124081,180069,6784,310934,6784
2020,CA,10,146084,154990,7985,309059,7985
2020,CA,11,90410,284861,8001,383272,8001
2020,CA,12,46574,337517,8037,392128,8037
2020,CA,13,33907,335474,7935,377316,7935
2020,CA,14,73798,279708,6662,360168,6662
2020,CA,15,94389,255422,7485,357296,7485
2020,CA,16,85647,129458,5424,220529,5424
2020,CA,17,79260,224903,6163,310326,6163
2020,CA,18,82172,294545,9279,385996,9279
2020,CA,19,91063,228232,6689,325984,6689
2020,CA,20,77969,226505,7672,312146,7672
2020,CA,21,74859,93560,3655,172074,3655
2020,CA,22,163584,146467,6783,316834,6783
2020,CA,23,176413,125068,7448,308929,7448
2020,CA,24,134810,221831,9861,366502,9861
2020,CA,25,153161,188421,7667,349249,7667
2020,CA,26,128914,216840,7543,353297,7543
2020,CA,27,104088,226666,6706,337460,6706
2020,CA,28,97112,252705,6659,356476,6659
2020,CA,29,59671,186796,5636,252103,5636
2020,CA,30,110935,258910,7016,376861,7016
2020,CA,31,115221,174178,6839,296238,6839
2020,CA,32,93155,184978,5776,283909,5776
2020,CA,33,120287,285906,8069,414262,8069
2020,CA,34,40552,193874,5518,239944,5518
2020,CA,35,83352,166339,5654,255345,5654
2020,CA,36,131304,173573,5433,310310,5433
2020,CA,37,45202,275573,6023,326798,6023
2020,CA,38,101867,207000,6806,315673,6806
2020,CA,39,154439,190090,6803,351332,6803
2020,CA,40,41875,156662,4681,203218,4681
2020,CA,41,96428,164574,5805,266807,5805
2020,CA,42,198259,170481,7209,375949,7209
2020,CA,43,61138,224694,6251,292083,6251
2020,CA,44,46174,188767,5781,240722,5781
2020,CA,45,181306,228624,8634,418564,8634
2020,CA,46,78247,150186,5074,233507,5074
2020,CA,47,115161,203636,7289,326086,7289
2020,CA,48,193832,199791,8136,401759,8136
2020,CA,49,167049,217061,8956,393066,8956
2020,CA,50,195430,166841,8617,370888,8617
2020,CA,51,76703,166289,5696,248688,5696
2020,CA,52,139172,257923,9925,407020,9925
2020,CA,53,119398,258866,8474,386738,8474
2020,CO,1,104864,358355,11142,474361,11142
2020,CO,2,178533,338297,11307,528137,11307
2020,CO,3,224996,200886,10339,436221,10339
2020,CO,4,276309,198971,13323,488603,13323
2020,CO,5,244530,186346,15860,446736,15860
2020,CO,6,175729,260642,11706,448077,11706
2020,CO,7,163104,263442,12765,439311,12765
2020,CT,1,127803,229220,5486,362509,5486
2020,CT,2,164461,205779,7703,377943,7703
2020,CT,3,137580,212317,4576,354473,4576
2020,CT,4,127566,237245,5128,369939,5128
2020,CT,5,157881,196119,5416,359416,5416
2020,DE,AL,200603,296268,7139,504010,7139
2020,DC,AL,18586,317323,8447,344356,8447
2020,FL,1,292048,143657,7503,443208,7503
2020,FL,2,263189,125993,4023,393205,4023
2020,FL,3,223087,170433,4935,398455,4935
2020,FL,4,306018,198489,7610,512117,7610
2020,FL,5,123621,215161,4688,343470,4688
2020,FL,6,263617,184593,4296,452506,4296
2020,FL,7,183414,226505,5555,415474,5555
2020,FL,8,272109,189808,5199,467116,5199
2020,FL,9,201924,232318,4912,439154,4912
2020,FL,10,141377,236868,4674,382919,4674
2020,FL,11,318054,164285,3816,486155,3816
2020,FL,12,266291,188631,5230,460152,5230
2020,FL,13,194721,211530,5642,411893,5642
2020,FL,14,158027,217177,5491,380695,5491
2020,FL,15,213736,179792,5616,399144,5616
2020,FL,16,262840,223366,5090,491296,5090
2020,FL,17,271177,155036,3576,429789,3576
2020,FL,18,244704,206388,3445,454537,3445
2020,FL,19,276165,182108,3541,461814,3541
2020,FL,20,72815,254658,2519,329992,2519
2020,FL,21,168216,237825,3228,409269,3228
2020,FL,22,171057,229644,3122,403823,3122
2020,FL,23,157621,224942,3015,385578,3015
2020,FL,24,71108,224408,2338,297854,2338
2020,FL,25,190679,118903,2128,311710,2128
2020,FL,26,184019,164356,2643,351018,2643
2020,FL,27,167420,178642,2702,348764,2702
2020,GA,1,184821,143607,4492,332920,4492
2020,GA,2,120713,155087,2361,278161,2361
2020,GA,3,235907,140164,4667,380738,4667
2020,GA,4,72374,281769,3591,357734,3591
2020,GA,5,45867,313230,4154,363251,4154
2020,GA,6,175203,220636,6191,402030,6191
2020,GA,7,175253,199035,5401,379689,5401
2020,GA,8,195888,116946,3334,316168,3334
2020,GA,9,291950,85463,4805,382218,4805
2020,GA,10,230785,151614,4824,387223,4824
2020,GA,11,234956,171688,6644,413288,6644
2020,GA,12,177097,136635,3805,317537,3805
2020,GA,13,85815,277573,3861,367249,3861
2020,GA,14,235208,81060,4008,320276,4008
2020,HI,1,96986,179411,4703,281100,4703
2020,HI,2,99814,186659,6786,293259,6786
2020,ID,1,313559,140452,13546,467557,13546
2020,ID,2,240560,146569,13651,400780,13651
2020,IL,1,85028,246954,4855,336837,4855
2020,IL,2,65329,236640,4080,306049,4080
2020,IL,3,138158,175934,5293,319385,5293
2020,IL,4,43898,184645,4825,233368,4825
2020,IL,5,101619,267680,7178,376477,7178
2020,IL,6,176221,226804,8802,411827,8802
2020,IL,7,41975,274291,5282,321548,5282
2020,IL,8,115348,171840,5501,292689,5501
2020,IL,9,107388,269568,6380,383336,6380
2020,IL,10,110582,207379,5687,323648,5687
2020,IL,11,115078,195555,6247,316880,6247
2020,IL,12,184811,137911,6481,329203,6481
2020,IL,13,170480,158871,8318,337669,8318
2020,IL,14,195286,203744,8428,407458,8428
2020,IL,15,246927,88670,6322,341919,6322
2020,IL,16,197197,140938,7477,345612,7477
2020,IL,17,151009,146349,5723,303081,5723
2020,IL,18,218172,146098,5945,370215,5945
2020,IN,1,147926,177424,6241,331591,6241
2020,IN,2,179007,116992,5115,301114,5115
2020,IN,3,211169,112346,7545,331060,7545
2020,IN,4,219424,117151,7897,344472,7897
2020,IN,5,210257,200457,8673,419387,8673
2020,IN,6,231540,96000,4053,331593,4053
2020,IN,7,99811,177925,5589,283325,5589
2020,IN,8,212167,108018,6116,326301,6116
2020,IN,9,218208,136088,10300,364596,10300
2020,IA,1,213601,199259,8736,421596,8736
2020,IA,2,209858,193437,8410,411705,8410
2020,IA,3,224726,224159,9611,458496,9611
2020,IA,4,249487,142206,7381,399074,7381
2020,KS,1,207727,83890,6513,298130,6513
2020,KS,2,191030,140303,8024,339357,8024
2020,KS,3,179583,223114,8542,411239,8542
2020,KS,4,193066,123016,7495,323577,7495
2020,KY,1,244122,85228,4830,334180,4830
2020,KY,2,246865,111859,6584,365308,6584
2020,KY,3,141027,221843,7300,370170,7300
2020,KY,4,250481,129335,7313,387129,7313
2020,KY,5,241712,56153,3806,301671,3806
2020,KY,6,202439,168056,7764,378259,7764
2020,LA,1,266348,119830,7490,393668,7490
2020,LA,2,80094,258112,5082,343288,5082
2020,LA,3,242734,107458,6131,356323,6131
2020,LA,4,202016,121380,4974,328370,4974
2020,LA,5,214686,113525,4927,333138,4927
2020,LA,6,249898,135729,7526,393153,7526
2020,ME,1,164045,266376,12691,443112,12691
2020,ME,2,196692,168696,10961,376349,10961
2020,MD,1,236906,157430,10873,405209,10873
2020,MD,2,110901,225433,8244,344578,8244
2020,MD,3,112328,263027,10389,385744,10389
2020,MD,4,69533,286724,8443,364700,8443
2020,MD,5,119771,276896,9339,406006,9339
2020,MD,6,140735,227214,9481,377430,9481
2020,MD,7,66703,261237,7842,335782,7842
2020,MD,8,119537,287062,10983,417582,10983
2020,MA,1,135655,224939,8630,369224,8630
2020,MA,2,140377,240547,10314,391238,10314
2020,MA,3,132757,243303,9539,385599,9539
2020,MA,4,144654,276820,9957,431431,9957
2020,MA,5,97562,304072,8843,410477,8843
2020,MA,6,159252,279782,9959,448993,9959
2020,MA,7,43074,276091,5938,325103,5938
2020,MA,8,137738,283426,9396,430560,9396
2020,MA,9,176133,253222,9422,438777,9422
2020,MI,1,244455,171402,6554,422411,6554
2020,MI,2,225408,177044,7418,409870,7418
2020,MI,3,207762,194575,7882,410219,7882
2020,MI,4,234439,142631,6438,383508,6438
2020,MI,5,173212,189227,5416,367855,5416
2020,MI,6,197508,180142,7105,384755,7105
2020,MI,7,224583,164941,6768,396292,6768
2020,MI,8,215649,212085,7004,434738,7004
2020,MI,9,175081,229258,5764,410103,5764
2020,MI,10,273871,146887,5704,426462,5704
2020,MI,11,216799,237696,6248,460743,6248
2020,MI,12,134892,251770,5417,392079,5417
2020,MI,13,58162,229535,3435,291132,3435
2020,MI,14,68031,276847,3167,348045,3167
2020,MN,1,202121,164139,8904,375164,8904
2020,MN,2,197004,226589,10622,434215,10622
2020,MN,3,178214,265537,10393,454144,10393
2020,MN,4,123300,273204,9474,405978,9474
2020,MN,5,72323,328764,9788,410875,9788
2020,MN,6,251056,165370,10421,426847,10421
2020,MN,7,234753,126528,7667,368948,7667
2020,MN,8,225291,166939,8762,400992,8762
2020,MS,1,222287,115883,4957,343127,4957
2020,MS,2,105474,191701,3501,300676,3501
2020,MS,3,210914,135179,4421,350514,4421
2020,MS,4,218056,96731,4687,319474,4687
2020,MO,1,57522,254122,6265,317909,6265
2020,MO,2,223991,220318,8841,453150,8841
2020,MO,3,275741,129115,8149,413005,8149
2020,MO,4,243733,117921,8173,369827,8173
2020,MO,5,142648,206288,8038,356974,8038
2020,MO,6,247238,138964,7220,393422,7220
2020,MO,7,260930,103924,7838,372692,7838
2020,MO,8,260651,72321,4952,337924,4952
2020,MT,AL,343602,244786,15286,603674,15286
2020,NE,1,180290,132261,9335,321886,9335
2020,NE,2,154377,176468,8821,339666,8821
2020,NE,3,222179,65854,6798,294831,6798
2020,NV,1,84964,143410,4960,233334,4960
2020,NV,2,210255,171024,11338,392617,11338
2020,NV,3,213257,214147,8366,435770,8366
2020,NV,4,161358,174857,7398,343613,7398
2020,NH,1,188999,213662,6863,409524,6863
2020,NH,2,176655,211259,6900,394814,6900
2020,NJ,1,142821,242185,6734,391740,6734
2020,NJ,2,192184,181602,5839,379625,5839
2020,NJ,3,218016,217223,7262,442501,7262
2020,NJ,4,236896,191273,6115,434284,6115
2020,NJ,5,202253,225231,8176,435660,8176
2020,NJ,6,139170,191859,5051,336080,5051
2020,NJ,7,195246,239104,9380,443730,9380
2020,NJ,8,69201,182963,3150,255314,3150
2020,NJ,9,118533,199644,4184,322361,4184
2020,NJ,10,45312,254721,2848,302881,2848
2020,NJ,11,208009,237919,7627,453555,7627
2020,NJ,12,113426,242782,6014,362222,6014
2020,NM,1,122226,195608,7544,325378,7544
2020,NM,2,148487,116315,5418,270220,5418
2020,NM,3,130955,187927,5658,324540,5658
2020,NY,1,198826,182793,4710,386329,4710
2020,NY,2,183204,168779,4141,356124,4141
2020,NY,3,175089,216247,4100,395436,4100
2020,NY,4,165073,211700,3924,380697,3924
2020,NY,5,44495,229459,1554,275508,1554
2020,NY,6,92371,152725,2159,247255,2159
2020,NY,7,40366,190811,2044,233221,2044
2020,NY,8,46711,234960,1883,283554,1883
2020,NY,9,50873,232347,2130,285350,2130
2020,NY,10,65611,218141,2775,286527,2775
2020,NY,11,163857,132366,2640,298863,2640
2020,NY,12,49337,280012,3471,332820,3471
2020,NY,13,29526,233234,2112,264872,2112
2020,NY,14,57174,161973,1835,220982,1835
2020,NY,15,25855,171328,1015,198198,1015
2020,NY,16,73665,232782,2723,309170,2723
2020,NY,17,140332,212254,3617,356203,3617
2020,NY,18,166448,184181,5087,355716,5087
2020,NY,19,177569,182965,6948,367482,6948
2020,NY,20,141619,217340,7423,366382,7423
2020,NY,21,175345,141679,6252,323276,6252
2020,NY,22,176465,139592,6727,322784,6727
2020,NY,23,175243,139037,6996,321276,6996
2020,NY,24,155222,186983,7756,349961,7756
2020,NY,25,137342,218504,7759,363605,7759
2020,NY,26,119410,209957,5889,335256,5889
2020,NY,27,224305,162337,8169,394811,8169
2020,NC,1,160225,190636,2898,353759,2898
2020,NC,2,172408,327277,8133,507818,8133
2020,NC,3,226647,140468,5152,372267,5152
2020,NC,4,159083,326921,6264,492268,6264
2020,NC,5,266629,124924,4103,395656,4103
2020,NC,6,155373,257242,5095,417710,5095
2020,NC,7,266887,189064,5567,461518,5567
2020,NC,8,207285,178219,5335,390839,5335
2020,NC,9,214159,176512,4543,395214,4543
2020,NC,10,283446,130911,4624,418981,4624
2020,NC,11,252075,197059,5948,455082,5948
2020,NC,12,126477,316999,6214,449690,6214
2020,NC,13,266419,127555,4531,398505,4531
2020,ND,AL,235595,114902,11322,361819,11322
2020,OH,1,198433,185947,5846,390226,5846
2020,OH,2,214600,165593,5723,385916,5723
2020,OH,3,93890,231278,5326,330494,5326
2020,OH,4,237144,110336,5793,353273,5793
2020,OH,5,237762,141528,6584,385874,6584
2020,OH,6,248554,91296,4389,344239,4389
2020,OH,7,237313,120706,5338,363357,5338
2020,OH,8,243068,119846,5443,368357,5443
2020,OH,9,124569,184337,4634,313540,4634
2020,OH,10,188673,172471,6158,367302,6158
2020,OH,11,60902,252725,3178,316805,3178
2020,OH,12,232901,206386,6885,446172,6885
2020,OH,13,159938,171245,4713,335896,4713
2020,OH,14,222983,185689,5169,413841,5169
2020,OH,15,221898,166098,5953,393949,5953
2020,OH,16,232207,173685,5247,411139,5247
2020,OK,1,202879,125905,8711,337495,8711
2020,OK,2,221123,64353,5099,290575,5099
2020,OK,3,232416,72141,7068,311625,7068
2020,OK,4,208407,102925,8140,319472,8140
2020,OK,5,155455,138566,7511,301532,7511
2020,OR,1,160808,298753,16602,476163,16602
2020,OR,2,261602,197922,13673,473197,13673
2020,OR,3,112555,356659,14239,483453,14239
2020,OR,4,219851,238619,15764,474234,15764
2020,OR,5,203631,248430,15212,467273,15212
2020,PA,1,207433,233446,4687,445566,4687
2020,PA,2,86047,207155,2897,296099,2897
2020,PA,3,31693,356349,3614,391656,3614
2020,PA,4,168203,276497,4703,449403,4703
2020,PA,5,137570,263290,3520,404380,3520
2020,PA,6,170600,232017,5205,407822,5205
2020,PA,7,180615,199073,4584,384272,4584
2020,PA,8,184335,168580,3808,356723,3808
2020,PA,9,232092,122509,5316,359917,5316
2020,PA,10,199207,188308,6595,394110,6595
2020,PA,11,233073,148521,6119,387713,6119
2020,PA,12,232289,107863,5283,345435,5283
2020,PA,13,266382,101991,4667,373040,4667
2020,PA,14,240182,135799,4484,380465,4484
2020,PA,15,250188,96658,4851,351697,4851
2020,PA,16,212103,144530,4943,361576,4943
2020,PA,17,209491,221394,6729,437614,6729
2020,PA,18,134830,252857,5849,393536,5849
2020,RI,1,83607,154430,4773,242810,4773
2020,RI,2,116315,153056,5576,274947,5576
2020,SC,1,222708,197288,7598,427594,7598
2020,SC,2,200210,158948,5777,364935,5777
2020,SC,3,228058,102331,4729,335118,4729
2020,SC,4,215237,140939,6567,362743,6567
2020,SC,5,211989,150853,4917,367759,4917
2020,SC,6,92192,194414,3489,290095,3489
2020,SC,7,214709,146768,3608,365085,3608
2020,SD,AL,261043,150471,11095,422609,11095
2020,TN,1,242684,70462,5407,318553,5407
2020,TN,2,228992,124230,6902,360124,6902
2020,TN,3,219242,110460,5892,335594,5892
2020,TN,4,239420,108746,6428,354594,6428
2020,TN,5,127525,209961,10372,347858,10372
2020,TN,6,273647,96366,6457,376470,6457
2020,TN,7,245870,115156,6556,367582,6556
2020,TN,8,225471,114529,4844,344844,4844
2020,TN,9,48919,193596,3963,246478,3963
2020,TX,1,219683,83200,3718,306601,3718
2020,TX,2,174980,170430,5050,350460,5050
2020,TX,3,214359,209859,7811,432029,7811
2020,TX,4,257487,84709,4284,346480,4284
2020,TX,5,172395,107494,3470,283359,3470
2020,TX,6,175101,164746,4864,344711,4864
2020,TX,7,143176,170060,4329,317565,4329
2020,TX,8,274224,109291,5213,388728,5213
2020,TX,9,54944,178908,2514,236366,2514
2020,TX,10,210815,203922,7031,421768,7031
2020,TX,11,235070,58487,3656,297213,3656
2020,TX,12,224477,140677,6227,371381,6227
2020,TX,13,220060,54081,3946,278087,3946
2020,TX,14,185961,124630,4417,315008,4417
2020,TX,15,115200,120031,2725,237956,2725
2020,TX,16,77673,161215,4322,243210,4322
2020,TX,17,172297,137685,6082,316064,6082
2020,TX,18,57669,189823,3348,250840,3348
2020,TX,19,195938,71250,3992,271180,3992
2020,TX,20,96914,177548,4971,279433,4971
2020,TX,21,232811,220450,8087,461348,8087
2020,TX,22,210011,206114,6198,422323,6198
2020,TX,23,151578,145969,4321,301868,4321
2020,TX,24,161671,180609,5509,347789,5509
2020,TX,25,216248,177875,6885,401008,6885
2020,TX,26,248196,185956,7321,441473,7321
2020,TX,27,170876,104470,3711,279057,3711
2020,TX,28,115266,125463,3051,243780,3051
2020,TX,29,52937,106229,1916,161082,1916
2020,TX,30,50270,212373,3371,266014,3371
2020,TX,31,204096,192599,8512,405207,8512
2020,TX,32,151944,187919,5440,345303,5440
2020,TX,33,41209,117340,2232,160781,2232
2020,TX,34,98386,106812,2006,207204,2006
2020,TX,35,84766,187992,5527,278285,5527
2020,TX,36,221600,82881,3712,308193,3712
2020,UT,1,230315,113344,15161,358820,15161
2020,UT,2,207621,148903,13597,370121,13597
2020,UT,3,225831,131844,17014,374689,17014
2020,UT,4,201373,166191,16483,384047,16483
2020,VT,AL,112704,242820,11904,367428,11904
2020,VA,1,233151,213139,8455,454745,8455
2020,VA,2,168746,184886,7883,361515,7883
2020,VA,3,107942,230143,6629,344714,6629
2020,VA,4,146803,245932,6784,399519,6784
2020,VA,5,217584,183170,6594,407348,6594
2020,VA,6,231005,149404,8858,389267,8858
2020,VA,7,223199,228179,8422,459800,8422
2020,VA,8,84711,311470,8600,404781,8600
2020,VA,9,244958,98609,5037,348604,5037
2020,VA,10,189314,281722,9720,480756,9720
2020,VA,11,112774,280187,8012,400973,8012
2020,WA,1,166460,257631,15068,439159,15068
2020,WA,2,145138,257291,14504,416933,14504
2020,WA,3,214391,198429,13369,426189,13369
2020,WA,4,179022,122691,9623,311336,9623
2020,WA,5,215706,178895,14847,409448,14847
2020,WA,6,168250,244141,15731,428122,15731
2020,WA,7,58832,410067,12304,481203,12304
2020,WA,8,190801,218274,13463,422538,13463
2020,WA,9,88993,265393,9817,364203,9817
2020,WA,10,157058,216800,14642,388500,14642
2020,WV,1,183904,81849,4757,270510,4757
2020,WV,2,184784,92623,5149,282556,5149
2020,WV,3,176694,61512,3380,241586,3380
2020,WI,1,220664,182938,6853,410455,6853
2020,WI,2,136439,323807,7890,468136,7890
2020,WI,3,202659,184306,7689,394654,7689
2020,WI,4,71698,242003,4970,318671,4970
2020,WI,5,255819,187858,7518,451195,7518
2020,WI,6,232818,170457,7465,410740,7465
2020,WI,7,248822,165104,7101,421027,7101
2020,WI,8,241140,174136,7135,422411,7135
2020,WY,AL,193559,73491,9715,276765,9715
